,selected,transfers_balance,transfers_in,transfers_out,ict_index,value,label
0,76656,0,0,0,0.0,70,0
1,68335,-16828,995,17823,0.0,69,-1
2,59793,-11451,675,12126,0.0,69,0
3,56403,-5324,647,5971,0.0,68,-1
4,53689,-4224,616,4840,0.0,68,0
5,51023,-3184,276,3460,0.0,68,0
6,48026,-3147,57,3204,0.0,68,0
7,46467,-1691,38,1729,0.0,68,0
8,45182,-1364,14,1378,0.0,68,0
9,44753,-525,12,537,0.0,68,0
10,44303,-498,19,517,0.0,68,0
11,44061,-324,19,343,0.0,68,0
12,43855,-238,8,246,0.0,68,0
13,43696,-197,5,202,0.0,68,0
14,43434,-301,16,317,0.0,68,0
15,43310,-151,3,154,0.0,68,0
16,43178,-152,15,167,0.0,68,0
17,42915,-285,14,299,0.0,68,0
18,42856,-109,9,118,0.0,67,-1
19,42645,-237,3,240,0.0,67,0
20,42545,-103,0,103,0.0,67,0
21,42434,-109,0,109,0.0,67,0
22,42302,-134,0,134,0.0,67,0
23,42152,-142,0,142,0.0,67,0
24,42028,-132,0,132,0.0,67,0
0,69564,0,0,0,0.0,55,0
1,49797,-23455,1738,25193,0.0,55,0
2,61983,711,7407,6696,2.3,55,0
3,69592,1264,6180,4916,2.4,55,0
4,73952,-1132,5063,6195,3.7,55,0
5,79892,2396,6821,4425,1.3,55,0
6,72271,-8610,2305,10915,0.0,55,0
7,68445,-4860,1916,6776,0.0,55,0
8,71295,209,3796,3587,0.0,55,0
9,69062,-2987,1475,4462,2.0,55,0
10,63329,-5802,143,5945,0.0,55,0
11,60432,-3259,101,3360,0.0,55,0
12,58844,-1763,40,1803,0.5,55,0
13,59159,-84,855,939,4.3,54,-1
14,59418,-497,1037,1534,0.0,54,0
15,58025,-1474,164,1638,0.0,54,0
16,56695,-1414,73,1487,0.0,54,0
17,59279,407,1842,1435,1.6,54,0
18,58406,280,923,643,1.9,54,0
19,59961,675,1774,1099,0.4,54,0
20,60191,-150,900,1050,4.5,54,0
21,65560,4349,5240,891,0.0,54,0
22,59297,-6063,197,6260,0.0,54,0
23,60243,31,1353,1322,2.8,54,0
24,61292,380,1385,1005,0.0,54,0
0,2823465,0,0,0,10.6,120,0
1,3002806,-76570,146991,223561,7.9,120,0
2,2046859,-967555,50656,1018211,0.9,119,-1
3,2000213,-120167,106551,226718,4.4,119,0
4,1397443,-582811,29415,612226,4.1,118,-1
5,1193283,-235512,14819,250331,3.5,118,0
6,1011750,-191185,6334,197519,7.6,117,-1
7,1037701,7189,53375,46186,4.2,117,0
8,961065,-74110,43782,117892,5.9,117,0
9,850482,-107416,5512,112928,6.3,116,-1
10,742348,-108638,2646,111284,3.5,115,-1
11,703369,-47634,16755,64389,9.4,115,0
12,650088,-52013,4169,56182,7.7,115,0
13,635555,-16083,5217,21300,0.0,114,-1
14,569463,-64785,830,65615,0.0,114,0
15,566389,-5669,6786,12455,4.1,114,0
16,569293,1821,14647,12826,4.5,114,0
17,575850,-11762,13248,25010,5.0,113,-1
18,539555,-16905,1436,18341,12.2,113,0
19,548082,4886,36694,31808,0.0,113,0
20,524991,-22681,1164,23845,0.0,113,0
21,517358,-8191,3402,11593,2.1,113,0
22,526229,7644,14141,6497,1.1,113,0
23,515502,-11009,3811,14820,22.7,113,0
24,540800,22988,30474,7486,0.7,113,0
0,35774,0,0,0,0.0,50,0
1,27448,-11854,901,12755,0.0,49,-1
2,20173,-8218,449,8667,0.0,49,0
3,16771,-3849,218,4067,0.0,48,-1
4,16059,-1444,518,1962,0.0,48,0
5,15289,-1068,280,1348,0.0,48,0
6,14693,-822,212,1034,0.0,47,-1
7,14173,-687,234,921,0.0,47,0
8,13664,-725,173,898,0.0,47,0
9,13434,-368,153,521,0.0,47,0
10,13132,-426,133,559,0.0,47,0
11,12964,-302,122,424,0.0,46,-1
12,12905,-155,152,307,0.0,46,0
13,12764,-192,101,293,0.0,46,0
14,12539,-335,112,447,0.0,46,0
15,12503,-122,90,212,0.0,46,0
16,12433,-148,95,243,0.0,46,0
17,12671,-101,290,391,0.0,46,0
18,12414,-126,102,228,6.4,46,0
19,14542,1754,2437,683,4.5,46,0
20,16187,1473,2215,742,2.0,46,0
21,25009,8220,9002,782,2.6,46,0
22,26100,937,3365,2428,2.2,46,0
23,25084,-1208,1560,2768,4.6,46,0
24,24937,-506,1399,1905,0.0,46,0
0,196064,0,0,0,9.9,85,0
1,342387,59951,93434,33483,7.0,85,0
2,340935,-21852,47809,69661,10.7,85,0
3,395242,29347,65917,36570,0.0,85,0
4,339461,-58733,24370,83103,0.0,85,0
5,290288,-55111,7838,62949,7.0,85,0
6,256783,-38142,3406,41548,3.6,84,-1
7,254990,-5819,16777,22596,0.1,84,0
8,237159,-19270,6786,26056,0.0,84,0
9,218478,-19886,1759,21645,0.2,83,-1
10,207878,-12057,4397,16454,8.3,83,0
11,206347,-3653,7466,11119,5.3,83,0
12,199418,-7281,2375,9656,0.0,83,0
13,191024,-8941,978,9919,2.6,82,-1
14,184930,-7144,1896,9040,8.3,82,0
15,210136,22976,25879,2903,5.1,82,0
16,256906,44034,52898,8864,21.5,82,0
17,1080368,277285,315381,38096,1.0,83,1
18,443811,-56037,61342,117379,10.5,83,0
19,490598,13212,92457,79245,12.5,83,0
20,693962,196816,225624,28808,1.3,84,1
21,606267,-83087,48579,131666,3.1,84,0
22,627404,14102,53618,39516,2.0,84,0
23,503677,-120962,22015,142977,0.0,83,-1
24,396865,-112031,7246,119277,0.2,82,-1
0,400285,0,0,0,1.4,50,0
1,614046,71268,112820,41552,1.8,50,0
2,605224,-33085,57089,90174,3.6,50,0
3,675971,32333,67684,35351,1.1,50,0
4,689120,-1770,58395,60165,3.2,50,0
5,693944,-6968,29541,36509,1.2,50,0
6,664379,-33754,6637,40391,2.1,50,0
7,693574,17605,35861,18256,2.7,50,0
8,666919,-24402,9812,34214,3.2,50,0
9,679574,3905,16683,12778,2.3,50,0
10,648266,-28162,7916,36078,0.8,50,0
11,646390,-11334,14703,26037,2.1,50,0
12,610828,-33577,2735,36312,1.5,50,0
13,577628,-35279,2232,37511,0.8,50,0
14,532869,-44555,3358,47913,3.6,49,-1
15,554251,16320,27036,10716,2.0,49,0
16,615058,56845,72518,15673,1.9,49,0
17,975215,117258,160152,42894,2.0,49,0
18,690601,-21946,28671,50617,1.1,50,1
19,722859,4915,38783,33868,2.7,50,0
20,719531,-5667,20995,26662,2.6,50,0
21,753273,27868,37808,9940,0.9,50,0
22,591661,-158654,1266,159920,0.0,50,0
23,565889,-26979,6244,33223,2.3,50,0
24,560005,-10387,4804,15191,2.1,50,0
0,42909,0,0,0,4.5,55,0
1,58116,670,9879,9209,2.3,55,0
2,53341,-8902,3582,12484,1.0,55,0
3,53027,-3370,3893,7263,0.1,55,0
4,46661,-7416,1557,8973,0.8,54,-1
5,44236,-3447,953,4400,2.7,54,0
6,42146,-2737,789,3526,0.0,54,0
7,38929,-3460,489,3949,0.0,53,-1
8,36603,-2603,350,2953,1.3,53,0
9,36301,-666,555,1221,1.8,53,0
10,35154,-1294,355,1649,3.1,53,0
11,34460,-946,503,1449,0.2,52,-1
12,32282,-2201,150,2351,0.0,52,0
13,30646,-1675,25,1700,0.0,52,0
14,30003,-787,209,996,6.3,52,0
15,32591,2157,2661,504,3.2,52,0
16,33959,1156,2354,1198,1.2,52,0
17,36440,617,2800,2183,4.4,52,0
18,34262,-685,806,1491,3.2,52,0
19,34572,-260,1396,1656,5.9,52,0
20,34338,-383,786,1169,3.0,52,0
21,35561,884,1796,912,3.3,52,0
22,34750,-1005,569,1574,5.5,52,0
23,34072,-928,609,1537,4.6,52,0
24,33998,-342,477,819,3.5,52,0
0,769,0,0,0,0.0,45,0
1,740,-153,38,191,0.0,45,0
2,705,-83,69,152,0.0,45,0
3,667,-55,31,86,0.0,45,0
4,636,-50,45,95,0.0,45,0
5,630,-19,53,72,0.0,44,-1
6,608,-33,18,51,0.0,44,0
7,598,-16,17,33,0.0,44,0
8,582,-21,24,45,0.0,44,0
9,574,-13,11,24,0.0,44,0
10,808,188,208,20,0.0,44,0
11,950,92,170,78,0.0,44,0
12,989,-4,69,73,0.0,44,0
13,1010,-13,87,100,0.0,44,0
14,1047,-26,88,114,1.4,44,0
15,3105,1883,2047,164,4.1,44,0
16,11068,7658,8505,847,1.9,44,0
17,42047,12688,17856,5168,0.0,44,0
18,15566,-6244,1569,7813,0.0,44,0
19,11536,-5695,247,5942,0.0,44,0
20,8524,-3070,50,3120,0.0,44,0
21,6947,-1628,33,1661,0.0,44,0
22,6070,-942,93,1035,0.0,44,0
23,5672,-473,259,732,0.0,44,0
24,5384,-395,136,531,1.0,44,0
0,240975,0,0,0,4.0,50,0
1,326713,23037,54450,31413,1.7,50,0
2,323391,-19029,39377,58406,1.9,50,0
3,326848,-9896,23203,33099,7.5,50,0
4,403783,55973,95561,39588,1.3,50,0
5,430008,21627,47560,25933,3.2,50,0
6,426299,-6360,21355,27715,3.7,50,0
7,608923,158377,170047,11670,3.5,51,1
8,621663,18737,54815,36078,3.8,51,0
9,750799,112923,127906,14983,3.4,51,0
10,703566,-33015,33446,66461,3.9,52,1
11,698336,-20013,29204,49217,6.8,52,0
12,494094,-198316,1986,200302,0.0,52,0
13,440896,-59084,4476,63560,0.0,51,-1
14,378127,-62919,4095,67014,5.4,51,0
15,411670,28672,41597,12925,3.2,51,0
16,480458,65056,80327,15271,2.8,51,0
17,471562,-20250,37766,58016,5.3,51,0
18,408658,-39404,11754,51158,0.0,51,0
19,385321,-39659,7927,47586,2.4,51,0
20,358635,-27533,3551,31084,4.8,51,0
21,384060,22723,29707,6984,3.5,51,0
22,373563,-11160,10297,21457,4.1,51,0
23,355853,-17381,8231,25612,9.0,51,0
24,365269,5551,17881,12330,1.0,51,0
0,1043,0,0,0,0.0,45,0
1,1100,-177,75,252,0.0,45,0
2,1040,-117,83,200,0.0,45,0
3,989,-94,49,143,0.0,45,0
4,951,-62,46,108,0.0,45,0
5,935,-30,30,60,0.0,45,0
6,921,-35,27,62,0.0,45,0
7,902,-29,26,55,0.0,45,0
8,902,-19,33,52,0.0,45,0
9,897,-22,14,36,0.0,45,0
10,943,15,57,42,0.0,45,0
11,1167,97,156,59,0.0,45,0
12,1254,23,88,65,0.0,45,0
13,1343,30,96,66,0.0,45,0
14,1525,42,162,120,0.0,45,0
15,1649,66,157,91,0.0,45,0
16,1787,53,192,139,0.0,45,0
17,2344,82,385,303,0.0,45,0
18,2085,-12,141,153,0.0,45,0
19,2211,2,184,182,0.0,45,0
20,2242,-33,89,122,0.0,45,0
21,2358,22,121,99,0.0,45,0
22,2479,19,130,111,0.0,45,0
23,2550,-36,143,179,0.0,45,0
24,2641,-16,103,119,0.0,45,0
0,71148,0,0,0,2.2,45,0
1,148466,46375,72351,25976,1.4,45,0
2,171240,14874,51839,36965,3.2,45,0
3,189724,10811,26789,15978,0.0,45,0
4,164456,-24136,7257,31393,0.0,45,0
5,123830,-40959,648,41607,0.0,45,0
6,92334,-33356,53,33409,1.7,45,0
7,95909,1275,9205,7930,1.9,44,-1
8,96088,-142,5576,5718,2.0,44,0
9,102685,5101,7708,2607,1.0,44,0
10,96512,-5120,2600,7720,1.9,44,0
11,99927,1564,6247,4683,3.2,44,0
12,97987,-1764,3292,5056,2.2,44,0
13,97938,-497,4861,5358,0.8,44,0
14,92791,-5343,4960,10303,5.0,44,0
15,116761,22703,26197,3494,2.3,44,0
16,218164,98931,106244,7313,7.2,44,0
17,508703,117135,150637,33502,4.6,45,1
18,325639,12377,53040,40663,2.2,45,0
19,388543,40486,74592,34106,2.3,45,0
20,395570,5438,37996,32558,2.6,45,0
21,481819,81425,89716,8291,2.0,45,0
22,457304,-24031,18607,42638,4.1,46,1
23,412288,-41326,12154,53480,0.2,46,0
24,382065,-35845,7332,43177,3.8,45,-1
0,686005,0,0,0,1.7,55,0
1,777005,659,56372,55713,0.0,55,0
2,518268,-248129,7001,255130,2.9,55,0
3,493590,-46465,10701,57166,3.7,54,-1
4,409553,-84040,6985,91025,2.1,54,0
5,400394,-17548,7930,25478,4.8,54,0
6,389707,-13105,6304,19409,3.3,54,0
7,399389,5325,16322,10997,5.6,54,0
8,385313,-13884,7457,21341,3.0,54,0
9,385015,-2524,7079,9603,3.6,54,0
10,362972,-20736,3692,24428,4.0,54,0
11,355156,-11665,5817,17482,6.6,54,0
12,340689,-14317,2669,16986,1.9,54,0
13,327723,-13648,2480,16128,8.1,53,-1
14,303802,-24036,2649,26685,2.4,53,0
15,329181,22400,27275,4875,4.4,53,0
16,374600,42695,50315,7620,15.0,53,0
17,1461705,380624,413810,33186,0.0,54,1
18,588058,-124876,24855,149731,3.8,54,0
19,642438,13678,73299,59621,0.0,54,0
20,561453,-78339,5800,84139,0.0,54,0
21,477165,-85317,2786,88103,0.0,53,-1
22,385683,-92757,589,93346,0.0,53,0
23,334286,-50706,663,51369,0.0,52,-1
24,327660,-9799,3957,13756,6.0,52,0
0,132947,0,0,0,2.3,80,0
1,95969,-46967,2864,49831,1.1,79,-1
2,69956,-31642,1751,33393,0.1,78,-1
3,63489,-10151,2000,12151,5.5,78,0
4,65683,-2205,5320,7525,3.0,77,-1
5,66280,-1158,4158,5316,0.1,77,0
6,64070,-3323,2541,5864,0.0,77,0
7,60944,-3964,1918,5882,2.5,77,0
8,59165,-3125,1315,4440,1.6,76,-1
9,53233,-6046,250,6296,0.0,76,0
10,49800,-3578,106,3684,0.0,76,0
11,48239,-1711,109,1820,0.0,76,0
12,49173,713,1419,706,4.7,76,0
13,49800,371,1131,760,6.3,76,0
14,51388,838,2151,1313,0.7,76,0
15,51851,133,1709,1576,0.0,76,0
16,51438,-829,1372,2201,0.0,76,0
17,52028,-1069,1546,2615,0.7,76,0
18,50204,-1016,307,1323,0.0,76,0
19,49777,-984,558,1542,7.7,76,0
20,50734,581,1227,646,8.4,76,0
21,56493,4986,6172,1186,10.2,76,0
22,66332,8545,11293,2748,5.8,76,0
23,64506,-2335,4321,6656,0.0,76,0
24,59644,-5384,966,6350,2.8,76,0
0,5478,0,0,0,0.0,55,0
1,5332,-1235,225,1460,0.0,54,-1
2,4712,-913,193,1106,0.0,54,0
3,4571,-370,242,612,0.0,53,-1
4,3906,-707,60,767,0.0,53,0
5,3655,-317,43,360,0.0,52,-1
6,3683,-71,119,190,0.0,52,0
7,3627,-103,121,224,0.0,52,0
8,3376,-261,16,277,0.5,52,0
9,3578,141,235,94,1.9,52,0
10,3576,-39,137,176,0.0,52,0
11,3498,-97,61,158,0.0,52,0
12,3397,-110,9,119,0.0,52,0
13,3317,-88,9,97,0.0,52,0
14,3346,-24,82,106,0.0,51,-1
15,3321,-42,39,81,0.0,51,0
16,3346,-20,58,78,0.0,51,0
17,3375,-72,83,155,0.0,51,0
18,3329,6,62,56,0.0,51,0
19,3390,10,107,97,0.0,51,0
20,3370,-52,23,75,0.0,51,0
21,3385,-20,38,58,0.0,51,0
22,3404,-21,34,55,0.0,51,0
23,3410,-45,43,88,0.0,51,0
24,3392,-41,30,71,0.0,51,0
0,112190,0,0,0,0.0,60,0
1,83645,-34641,3801,38442,5.5,59,-1
2,80665,-11025,11733,22758,0.1,59,0
3,72091,-11704,6127,17831,2.7,58,-1
4,61050,-12941,3395,16336,0.2,58,0
5,56582,-5828,2798,8626,0.0,57,-1
6,51252,-6047,1137,7184,0.3,57,0
7,49054,-2833,1891,4724,4.9,56,-1
8,46936,-2869,1982,4851,0.0,56,0
9,45015,-2212,655,2867,0.0,56,0
10,43049,-2223,790,3013,1.7,55,-1
11,42578,-881,1286,2167,0.2,55,0
12,42140,-596,861,1457,6.3,55,0
13,42821,440,1769,1329,2.7,55,0
14,42782,-497,1821,2318,0.0,55,0
15,42355,-544,1028,1572,0.0,55,0
16,41763,-798,1144,1942,0.0,55,0
17,46549,1105,4416,3311,0.3,55,0
18,42894,-471,1606,2077,0.0,55,0
19,41676,-1588,1098,2686,0.0,55,0
20,40838,-987,571,1558,0.0,54,-1
21,41070,-32,1273,1305,0.0,54,0
22,40134,-1107,537,1644,0.0,54,0
23,39403,-904,615,1519,0.0,54,0
24,39220,-371,622,993,0.0,54,0
0,17820,0,0,0,0.0,45,0
1,13976,-3896,302,4198,0.0,45,0
2,12195,-2114,485,2599,0.0,45,0
3,11046,-1287,215,1502,0.0,45,0
4,14162,1518,3519,2001,0.0,44,-1
5,18104,2822,4836,2014,0.0,44,0
6,18094,220,1679,1459,0.0,44,0
7,17807,-414,1011,1425,0.0,44,0
8,18408,36,1560,1524,0.0,44,0
9,18114,-254,644,898,0.0,44,0
10,17474,-619,456,1075,0.0,44,0
11,17307,-300,410,710,0.0,44,0
12,17253,-89,408,497,0.0,44,0
13,17087,-233,333,566,0.0,44,0
14,17002,-218,531,749,4.7,44,0
15,25098,7408,8347,939,3.5,44,0
16,36415,11153,14188,3035,7.6,44,0
17,408204,141708,160130,18422,2.6,44,0
18,219564,51999,80084,28085,7.8,45,1
19,290496,65532,101301,35769,3.1,45,0
20,201113,-87304,6424,93728,5.9,45,0
21,201009,-2788,20648,23436,3.0,44,-1
22,182573,-18772,9000,27772,5.0,44,0
23,169536,-12767,18838,31605,6.0,43,-1
24,167726,-4453,17567,22020,0.0,43,0
0,491508,0,0,0,0.0,55,0
1,357292,-145334,7716,153050,5.8,54,-1
2,286264,-81091,14805,95896,0.0,54,0
3,243259,-47534,9105,56639,10.0,53,-1
4,224096,-24953,16280,41233,7.6,53,0
5,223383,-5116,18693,23809,7.4,53,0
6,208220,-16230,7667,23897,2.1,53,0
7,219061,7403,22944,15541,1.7,53,0
8,206289,-13205,12345,25550,5.6,53,0
9,191920,-15500,6336,21836,6.8,52,-1
10,178881,-13462,5492,18954,5.1,52,0
11,179778,-1264,10483,11747,9.5,52,0
12,173534,-6255,5118,11373,3.8,52,0
13,169035,-5246,5800,11046,6.8,52,0
14,164237,-5361,7476,12837,7.5,51,-1
15,290455,120012,126226,6214,12.9,51,0
16,424772,132869,153139,20270,13.9,52,1
17,1292064,338470,386443,47973,8.4,53,1
18,660260,-50834,73027,123861,15.6,53,0
19,833682,121386,185520,64134,9.9,53,0
20,944194,105509,151953,46444,0.0,54,1
21,773081,-167173,21708,188881,5.4,54,0
22,805284,21444,69362,47918,10.5,54,0
23,741694,-60506,45233,105739,3.2,53,-1
24,695537,-56899,27893,84792,5.7,53,0
0,2608,0,0,0,0.0,50,0
1,2378,-588,185,773,0.0,50,0
2,2073,-402,126,528,0.0,50,0
3,1959,-187,106,293,0.0,49,-1
4,1814,-172,100,272,0.0,49,0
5,1795,-51,91,142,0.0,49,0
6,1730,-84,54,138,0.0,49,0
7,1707,-33,53,86,0.0,49,0
8,1670,-46,61,107,0.0,49,0
9,1695,22,78,56,0.0,49,0
10,1780,75,143,68,0.0,49,0
11,1949,154,240,86,0.0,49,0
12,2174,225,294,69,0.0,49,0
13,2439,255,340,85,0.9,49,0
14,8127,5371,5769,398,6.9,49,0
15,50710,41351,42429,1078,0.4,49,0
16,70189,19768,26105,6337,0.0,49,0
17,28819,-23775,5386,29161,0.0,49,0
18,27692,-18639,467,19106,0.4,49,0
19,23321,-6746,1170,7916,0.0,49,0
20,16714,-6656,358,7014,2.5,49,0
21,15113,-1749,869,2618,0.0,49,0
22,12570,-2608,222,2830,0.0,49,0
23,10579,-2026,291,2317,0.0,49,0
24,9529,-1211,165,1376,0.0,49,0
0,1121565,0,0,0,1.2,45,0
1,1159789,-21416,61649,83065,0.4,45,0
2,1227969,33686,143115,109429,0.8,45,0
3,1214001,-23063,46393,69456,1.0,45,0
4,1174518,-48683,55150,103833,0.3,45,0
5,1140776,-40165,24877,65042,1.3,45,0
6,1091946,-49697,6086,55783,0.0,45,0
7,1044465,-49506,9222,58728,1.2,45,0
8,1013226,-29558,11732,41290,2.0,45,0
9,990709,-25792,5071,30863,0.8,45,0
10,976199,-15494,11247,26741,1.2,45,0
11,973038,-9295,12610,21905,3.0,44,-1
12,970286,-4650,13263,17913,0.0,44,0
13,932077,-40082,10976,51058,0.0,44,0
14,868073,-63107,6654,69761,0.0,44,0
15,818452,-51746,4511,56257,0.0,43,-1
16,762122,-57760,9073,66833,0.0,43,0
17,650934,-51785,16240,68025,0.0,43,0
18,653914,-46755,5894,25019,0.0,42,-1
19,637379,-16359,1860,18219,0.0,42,0
20,611844,-25842,2388,28230,0.0,42,0
21,585247,-26741,1193,27934,0.0,42,0
22,556136,-29298,2574,31872,4.6,42,0
23,547090,-9518,8624,18142,0.0,42,0
24,538258,-9943,3330,13273,0.0,42,0
0,473242,0,0,0,11.5,80,0
1,1119588,407231,474433,67202,3.1,81,1
2,858445,-253539,81422,334961,1.5,81,0
3,902846,-2745,133795,136540,1.5,80,-1
4,667520,-236095,27924,264019,3.4,79,-1
5,500111,-175335,5542,180877,0.0,79,0
6,397965,-110167,2777,112944,0.8,78,-1
7,382402,-21502,14695,36197,3.4,78,0
8,343737,-39196,5602,44798,1.2,77,-1
9,300636,-43777,851,44628,4.6,77,0
10,285828,-16828,2840,19668,4.6,76,-1
11,291503,3255,16460,13205,8.0,76,0
12,279963,-11252,3786,15038,0.0,76,0
13,265343,-15174,1271,16445,2.6,76,0
14,253287,-12782,1696,14478,0.0,76,0
15,244532,-9076,302,9378,0.0,76,0
16,236445,-8280,104,8384,5.7,76,0
17,232966,-4993,1612,6605,0.0,75,-1
18,229545,-2633,264,2897,2.6,75,0
19,226966,-3283,634,3917,0.6,75,0
20,224982,-2258,169,2427,6.5,75,0
21,223888,-1393,570,1963,0.0,75,0
22,221787,-2370,272,2642,2.4,75,0
23,219854,-2313,324,2637,0.1,75,0
24,218444,-1744,169,1913,0.0,75,0
0,85593,0,0,0,8.5,50,0
1,705990,363239,412630,49391,3.5,50,0
2,883614,115293,228566,113273,0.0,51,1
3,918411,-1533,89214,90747,1.7,51,0
4,890460,-41407,49770,91177,3.9,51,0
5,876080,-25935,29722,55657,4.5,51,0
6,840298,-42750,13936,56686,2.7,51,0
7,868612,16887,41119,24232,2.7,51,0
8,845048,-23821,19312,43133,2.4,51,0
9,845745,-5839,13923,19762,7.6,51,0
10,876182,24901,47308,22407,2.3,51,0
11,896140,11249,43732,32483,4.5,51,0
12,854955,-38120,11815,49935,1.7,51,0
13,661743,-193220,2068,195288,0.0,50,-1
14,600780,-63740,6908,70648,0.0,50,0
15,527388,-74673,1803,76476,0.0,50,0
16,467678,-61380,139,61519,0.0,50,0
17,415903,-43077,958,44035,0.0,50,0
18,415147,-10840,1159,11999,0.0,50,0
19,405276,-12253,2041,14294,0.0,50,0
20,396358,-9340,805,10145,0.0,50,0
21,390042,-6744,1094,7838,1.1,50,0
22,386177,-4442,2262,6704,4.3,50,0
23,381018,-5454,1856,7310,1.0,50,0
24,378552,-3299,1713,5012,0.0,50,0
0,115657,0,0,0,1.1,50,0
1,112604,-15068,12146,27214,9.6,50,0
2,150896,23884,53185,29301,2.0,50,0
3,160888,5720,28964,23244,4.4,50,0
4,143308,-19459,11842,31301,3.7,50,0
5,124438,-20283,5035,25318,6.8,50,0
6,114897,-11541,3519,15060,0.0,50,0
7,102454,-12767,2126,14893,1.2,49,-1
8,92147,-10767,1997,12764,1.8,49,0
9,90464,-2977,2640,5617,1.8,49,0
10,85145,-5330,1961,7291,1.3,48,-1
11,82541,-3267,2188,5455,2.6,48,0
12,79616,-3039,1228,4267,4.5,48,0
13,76341,-3482,875,4357,3.8,48,0
14,75536,-1265,3382,4647,0.0,47,-1
15,73363,-2272,1451,3723,0.8,47,0
16,70937,-2630,1365,3995,6.2,47,0
17,72026,-1108,3977,5085,2.7,47,0
18,68234,-1713,1519,3232,0.0,47,0
19,63128,-5471,327,5798,0.0,47,0
20,59424,-3772,28,3800,0.0,47,0
21,57295,-2204,19,2223,0.0,47,0
22,56127,-1246,90,1336,0.0,47,0
23,54890,-1259,139,1398,4.0,47,0
24,54639,-399,272,671,0.0,47,0
0,0,0,0,0,3.2,45,0
1,110619,64746,89849,25103,0.0,45,0
2,110312,-3575,26010,29585,1.1,45,0
3,115620,197,16308,16111,4.1,45,0
4,106618,-10678,9987,20665,0.0,45,0
5,106534,-3370,10509,13879,0.0,44,-1
6,108585,-80,11131,11211,1.3,44,0
7,122825,11037,20099,9062,2.5,44,0
8,113605,-7676,14460,22136,0.0,44,0
9,104993,-9663,2230,11893,0.0,44,0
10,101792,-4187,4503,8690,0.0,44,0
11,102339,-652,5076,5728,3.1,44,0
12,102971,181,4661,4480,1.0,44,0
13,102019,-1450,3560,5010,1.0,44,0
14,104186,866,7568,6702,0.9,44,0
15,108519,3708,8246,4538,0.8,44,0
16,110296,1264,8446,7182,0.0,44,0
17,100781,-6752,7425,14177,0.0,44,0
18,95472,-8098,2606,10704,0.6,44,0
19,89291,-7979,1947,9926,1.2,44,0
20,83705,-6052,2740,8792,0.0,43,-1
21,78974,-4871,851,5722,0.0,43,0
22,75131,-4081,579,4660,0.0,43,0
23,76604,250,5712,5462,0.3,42,-1
24,77121,242,4260,4018,1.2,42,0
0,299,101,134,33,0.0,45,0
1,957,145,241,96,0.0,45,0
2,1541,123,324,201,0.0,45,0
3,1777,25,175,150,0.0,45,0
4,1970,7,127,120,0.0,45,0
5,2127,-5,145,150,0.0,45,0
6,2320,-12,121,133,0.0,45,0
7,2393,-29,77,106,0.0,45,0
8,2511,-24,104,128,0.0,45,0
9,2638,-14,92,106,0.0,45,0
10,2695,-13,69,82,0.0,45,0
11,2711,-53,54,107,0.0,45,0
12,2830,-24,104,128,0.0,45,0
13,2879,-23,58,81,0.0,45,0
14,2912,-45,77,122,0.0,45,0
15,3742,-2,222,224,0.0,45,0
16,3121,-10,104,114,0.0,45,0
17,3195,-36,110,146,0.0,45,0
18,3219,-34,33,67,0.0,45,0
19,3226,-33,47,80,1.7,44,-1
20,5107,1614,1960,346,0.0,44,0
21,4446,-653,219,872,0.0,44,0
22,4340,-186,145,331,0.0,44,0
0,36405,30080,33915,3835,0.3,50,0
1,51780,14296,20017,5721,2.2,50,0
2,59166,6000,12911,6911,3.8,50,0
3,85861,22577,28509,5932,2.7,50,0
4,64810,-19199,8239,27438,0.0,50,0
5,51099,-15129,682,15811,0.0,50,0
6,40546,-10758,525,11283,0.9,50,0
7,35876,-5346,702,6048,0.0,50,0
8,31810,-4174,102,4276,0.0,50,0
9,28639,-3279,83,3362,0.0,50,0
10,25580,-3056,154,3210,0.0,49,-1
11,24301,-1405,43,1448,0.0,49,0
12,22972,-1369,103,1472,0.0,49,0
13,21688,-1205,692,1897,2.6,49,0
14,22510,506,1016,510,5.1,49,0
15,25616,2519,3677,1158,1.8,49,0
16,23771,-1784,442,2226,2.2,49,0
17,25201,1023,1801,778,4.8,49,0
18,25207,-258,1019,1277,0.9,49,0
19,22318,-2851,141,2992,0.0,49,0
20,20849,-1573,35,1608,0.0,49,0
0,13675,13097,14154,1057,0.0,60,0
1,22952,8850,11226,2376,0.0,60,0
2,20124,-3158,3129,6287,1.2,60,0
3,17039,-3433,2359,5792,4.8,60,0
4,16774,-847,2313,3160,1.7,60,0
0,349600,38079,53128,15049,3.2,45,0
1,783041,333894,385360,51466,1.9,45,0
2,970195,154802,202024,47222,4.2,46,1
3,1479843,419020,459020,40000,2.8,47,1
4,1890748,373882,389263,15381,5.2,48,1
5,1988850,94491,125956,31465,0.4,48,0
6,1957640,-30823,55928,86751,2.1,48,0
7,2084116,90049,126674,36625,0.6,48,0
8,2056118,-17390,35488,52878,0.4,48,0
9,1866758,-31936,19427,51363,4.7,48,0
10,1985238,98119,107445,9326,2.6,48,0
11,2114994,125309,134531,9222,0.4,49,1
12,2218913,86007,109772,23765,3.4,49,0
13,2272107,48683,87622,38939,2.3,50,1
14,2319949,38220,90989,52769,5.1,50,0
15,2466933,92429,151930,59501,6.3,51,1
16,2466933,92429,151930,59501,1.1,51,0
17,2590876,101158,139797,38639,3.3,51,0
18,2594223,1517,45902,44385,3.3,51,0
19,2681487,76509,90112,13603,3.9,51,0
20,2737236,46603,79598,32995,2.2,52,1
21,2816678,72218,110845,38627,5.7,52,0
22,2925463,85519,105082,19563,2.6,53,1
23,3126231,177068,207416,30348,2.6,53,0
0,4151,-358,197,555,0.0,45,0
1,3823,-445,179,624,0.0,45,0
2,3703,-204,118,322,0.0,45,0
3,3605,-191,256,447,0.0,45,0
4,3447,-203,118,321,0.0,45,0
5,3306,-173,41,214,0.0,45,0
6,3205,-114,47,161,0.0,45,0
7,3113,-120,93,213,0.0,45,0
8,3054,-78,47,125,0.0,45,0
9,2955,-46,58,104,0.0,45,0
10,2958,-23,49,72,0.0,45,0
11,3238,143,217,74,0.0,45,0
12,3536,78,254,176,0.0,45,0
13,3682,46,178,132,0.0,45,0
14,3851,59,267,208,0.0,45,0
15,4551,141,416,275,0.0,45,0
16,4551,141,416,275,0.0,45,0
17,4790,153,495,342,0.0,45,0
18,4897,34,190,156,0.0,45,0
19,5016,34,189,155,0.0,45,0
20,5221,62,269,207,0.0,45,0
21,5316,-26,270,296,0.0,45,0
22,5383,-48,160,208,0.0,45,0
23,5517,-16,297,313,0.0,45,0
0,32682,-1073,2374,3447,0.0,45,0
1,30390,-3639,1678,5317,0.0,45,0
2,27770,-3359,639,3998,1.7,45,0
3,26449,-2084,1041,3125,0.0,44,-1
4,25430,-1326,827,2153,0.0,44,0
5,24502,-1212,517,1729,1.1,44,0
6,23639,-1018,317,1335,0.0,44,0
7,22920,-962,409,1371,0.0,43,-1
8,22517,-553,384,937,0.3,43,0
9,21728,-319,471,790,0.0,43,0
10,21705,-140,548,688,9.0,43,0
11,26327,4128,4841,713,0.0,43,0
12,29038,2221,4874,2653,0.1,43,0
13,29244,285,2059,1774,0.0,43,0
14,28245,-1063,1357,2420,0.0,43,0
15,26515,-688,804,1492,0.0,43,0
16,26515,-688,804,1492,0.0,43,0
17,25439,-1172,378,1550,0.0,43,0
18,24760,-736,201,937,0.0,43,0
19,24056,-768,131,899,0.0,43,0
20,23468,-641,173,814,0.0,43,0
21,22796,-726,222,948,0.5,43,0
22,24467,1534,2569,1035,3.9,43,0
23,34598,9309,11713,2404,1.2,43,0
0,22571,-750,2646,3396,0.0,45,0
1,21596,-2124,2704,4828,0.0,45,0
2,19759,-2342,774,3116,0.0,45,0
3,18620,-1783,973,2756,0.0,44,-1
4,17751,-1186,712,1898,0.0,44,0
5,16999,-1008,407,1415,0.0,44,0
6,16077,-1061,257,1318,0.0,44,0
7,15803,-563,839,1402,0.0,43,-1
8,15500,-449,386,835,0.0,43,0
9,14883,-274,410,684,0.0,43,0
10,14769,-214,338,552,0.0,43,0
11,14789,-96,490,586,0.0,43,0
12,14946,-27,910,937,0.0,43,0
13,14988,-50,854,904,0.0,43,0
14,14664,-429,504,933,0.0,43,0
15,14531,-73,516,589,0.2,42,-1
16,14531,-73,516,589,0.0,42,0
17,14444,-231,467,698,0.0,42,0
18,14371,-139,309,448,0.0,42,0
19,14194,-270,191,461,0.0,42,0
20,14103,-174,246,420,0.0,42,0
21,13918,-295,309,604,0.0,42,0
22,13872,-137,287,424,0.0,42,0
23,14076,84,613,529,0.0,42,0
0,351261,11879,27701,15822,0.0,40,0
1,373969,9160,39054,29894,0.0,40,0
2,384238,2277,17369,15092,0.0,40,0
3,403702,12730,47550,34820,0.0,40,0
4,406294,1629,23169,21540,0.0,40,0
5,409979,1702,10454,8752,0.0,40,0
6,412450,345,8648,8303,0.0,40,0
7,401443,-10484,10661,21145,0.0,40,0
8,403539,-1206,6010,7216,0.0,40,0
9,395886,458,5857,5399,0.0,40,0
10,393448,-2040,3965,6005,0.0,40,0
11,391105,-2917,3503,6420,0.0,40,0
12,391918,-412,6263,6675,0.0,40,0
13,380745,-11437,4164,15601,0.0,40,0
14,371527,-9623,4893,14516,0.0,40,0
15,347063,-14130,7437,21567,0.0,40,0
16,347063,-14130,7437,21567,0.0,40,0
17,338702,-8391,5089,13480,0.0,40,0
18,333316,-5679,2467,8146,0.0,40,0
19,327863,-5671,1622,7293,0.0,40,0
20,340245,9049,19001,9952,0.0,39,-1
21,348750,2434,20590,18156,0.0,39,0
22,348412,2126,15641,13515,0.0,39,0
23,364724,7353,32041,24688,0.0,39,0
0,9780,-1496,325,1821,0.0,45,0
1,7222,-2588,9647,12235,0.0,45,0
2,6251,-1074,26,1100,0.0,44,-1
3,5637,-639,58,697,0.0,44,0
4,5700,-97,166,263,0.0,44,0
5,5672,-125,87,212,0.0,44,0
6,5622,-115,55,170,0.0,44,0
7,5436,-253,81,334,0.0,44,0
8,5178,-263,6,269,0.0,44,0
9,4868,-111,25,136,0.0,44,0
10,4899,-4,65,69,0.0,44,0
11,4958,15,100,85,0.0,44,0
12,5017,-6,140,146,0.0,44,0
13,5053,-6,89,95,0.0,44,0
14,5065,-36,83,119,0.0,44,0
15,5119,1,82,81,0.0,44,0
16,5119,1,82,81,0.0,44,0
17,5134,-26,106,132,0.0,44,0
18,5153,-6,76,82,0.0,44,0
19,5183,0,80,80,0.0,44,0
20,5151,-58,52,110,0.0,44,0
21,5163,-29,97,126,0.0,44,0
22,5182,-12,74,86,0.0,44,0
23,5233,1,120,119,0.0,44,0
0,688315,491,66945,66454,9.7,70,0
1,658262,-48718,44657,93375,13.1,70,0
2,665271,-8464,49799,58263,24.6,70,0
3,1483728,706988,774107,67119,8.4,71,1
4,2033015,536103,596944,60841,7.2,72,1
5,2100641,73559,217546,143987,21.6,73,1
6,2374506,248595,322493,73898,13.7,74,1
7,3065896,603650,641362,37712,6.2,76,1
8,3137111,115360,231483,116123,16.5,76,0
9,3131985,279319,368428,89109,11.1,77,1
10,3321262,178774,257181,78407,13.8,78,1
11,3353449,28505,139033,110528,17.2,78,0
12,3369640,-109,159602,159711,13.5,78,0
13,3185851,-185648,66733,252381,5.9,78,0
14,2990913,-206891,74763,281654,10.0,77,-1
15,2778647,-43343,132773,176116,5.3,77,0
16,2778647,-43343,132773,176116,9.3,77,0
17,2959349,145310,274343,129033,17.3,77,0
18,2988917,24148,124676,100528,5.4,77,0
19,3171088,170073,210952,40879,9.4,78,1
20,3255300,72166,133011,60845,8.4,78,0
21,3161099,-88546,101632,190178,1.5,78,0
22,2970283,-215768,43355,259123,0.0,77,-1
23,1942313,-1004243,22172,1026415,0.0,76,-1
0,34888,-823,2703,3526,6.0,55,0
1,32594,-2945,1806,4751,13.1,55,0
2,50152,14247,20155,5908,9.3,55,0
3,98414,40927,57006,16079,6.1,55,0
4,189102,84413,100045,15632,1.1,55,0
5,203486,13944,34058,20114,2.4,55,0
6,174706,-27781,9199,36980,5.5,55,0
7,172965,-4125,22059,26184,2.8,55,0
8,167461,-6684,12572,19256,3.3,55,0
9,128090,-9501,4010,13511,2.9,55,0
10,139192,10173,16110,5937,2.6,55,0
11,135720,-3619,5859,9478,2.8,55,0
12,128904,-7276,5729,13005,1.2,55,0
13,120563,-8761,2498,11259,4.3,55,0
14,114091,-7108,4825,11933,3.6,55,0
15,104877,-2322,6796,9118,0.8,55,0
16,104877,-2322,6796,9118,0.0,55,0
17,96069,-8911,1867,10778,5.0,55,0
18,86859,-9370,460,9830,2.7,55,0
19,82623,-4473,592,5065,1.7,55,0
20,78215,-4603,535,5138,2.8,55,0
21,73916,-4264,942,5206,3.4,55,0
22,71446,-2883,419,3302,3.2,55,0
23,75963,3755,6488,2733,1.0,55,0
0,5448,-388,251,639,0.0,45,0
1,5292,-615,239,854,0.0,45,0
2,4816,-689,61,750,0.0,45,0
3,4067,-778,44,822,0.0,44,-1
4,3696,-397,23,420,0.0,44,0
5,3331,-375,11,386,0.0,44,0
6,3086,-253,15,268,0.0,44,0
7,3119,-61,73,134,0.0,44,0
8,3169,-12,77,89,0.0,44,0
9,3162,-41,60,101,0.0,44,0
10,3152,-28,40,68,1.3,44,0
11,3722,471,557,86,1.9,44,0
12,6192,2070,2495,425,8.9,44,0
13,31828,23989,25658,1669,2.1,44,0
14,45656,14058,19621,5563,0.0,44,0
15,55098,6149,14879,8730,0.0,44,0
16,55098,6149,14879,8730,0.0,44,0
17,42971,-9469,2421,11890,0.0,44,0
18,30994,-11952,35,11987,0.0,44,0
19,24591,-6563,16,6579,0.0,44,0
20,19632,-5035,24,5059,0.0,44,0
21,16135,-3408,33,3441,0.0,44,0
22,14748,-1577,19,1596,0.0,44,0
23,13059,-1628,38,1666,0.0,44,0
0,89093,-472,10358,10830,6.3,55,0
1,82853,-10476,6683,17159,4.0,55,0
2,78280,-7713,4618,12331,9.2,55,0
3,76777,-5202,6657,11859,2.4,55,0
4,76692,-1846,6231,8077,2.4,54,-1
5,72519,-5100,2997,8097,8.1,54,0
6,66168,-6814,1877,8691,6.5,54,0
7,67622,-33,5912,5945,10.5,53,-1
8,69114,866,5313,4447,6.2,53,0
9,63282,-1422,2850,4272,0.0,53,0
10,58722,-4811,1332,6143,0.0,53,0
11,49226,-9570,40,9610,0.0,53,0
12,42773,-6520,65,6585,0.0,52,-1
13,40950,-2003,32,2035,0.0,52,0
14,39065,-1929,48,1977,0.0,52,0
15,36420,-712,15,727,0.0,52,0
16,36420,-712,15,727,2.1,52,0
17,36080,-496,260,756,0.2,52,0
18,35939,-226,153,379,0.0,52,0
19,35792,-256,164,420,0.2,52,0
20,35660,-246,113,359,0.2,52,0
21,35524,-276,235,511,0.2,52,0
22,35382,-258,130,388,1.2,52,0
23,35515,-5,388,393,0.1,52,0
0,94974,-3793,4157,7950,5.1,50,0
1,155915,33228,44618,11390,9.6,50,0
2,268558,85306,104350,19044,2.7,50,0
3,424835,120209,157777,37568,2.1,51,1
4,750216,297802,320289,22487,2.2,52,1
5,749568,9373,62436,53063,10.1,52,0
6,788897,31506,63683,32177,1.8,52,0
7,1035405,205584,230729,25145,3.4,53,1
8,993662,-14905,40062,54967,0.6,53,0
9,862322,-36585,15076,51661,2.8,53,0
10,914851,42123,54530,12407,4.2,53,0
11,993721,76396,89584,13188,3.0,53,0
12,1087827,85345,121682,36337,0.0,54,1
13,796863,-280017,4969,284986,0.0,54,0
14,764517,-42351,19081,61432,2.4,54,0
15,688736,-25483,12268,37751,4.1,54,0
16,688736,-25483,12268,37751,2.9,54,0
17,673542,-23629,16187,39816,3.8,54,0
18,646403,-27911,6210,34121,2.5,54,0
19,649782,1247,13490,12243,4.2,54,0
20,635422,-15751,8337,24088,2.3,54,0
21,644113,6349,26712,20363,3.2,54,0
22,652527,4191,20085,15894,2.2,54,0
23,674342,17043,39451,22408,5.7,54,0
0,59892,-2667,4138,6805,1.4,45,0
1,65844,2569,11484,8915,1.1,45,0
2,65893,-881,5551,6432,1.4,45,0
3,80822,11706,23969,12263,3.2,45,0
4,125979,41958,51096,9138,3.7,45,0
5,134893,8960,16120,7160,7.2,45,0
6,126997,-7530,5429,12959,3.0,45,0
7,212390,76274,88717,12443,2.3,45,0
8,209693,2094,15867,13773,6.9,45,0
9,197126,3597,12045,8448,3.5,45,0
10,229771,30074,33890,3816,2.4,45,0
11,272198,41105,45347,4242,5.1,46,1
12,311207,35352,48834,13482,2.5,46,0
13,332997,21141,50344,29203,1.2,46,0
14,359399,25517,55494,29977,2.5,46,0
15,381635,22529,60462,37933,2.1,46,0
16,381635,22529,60462,37933,3.5,46,0
17,452496,66890,95269,28379,6.7,47,1
18,512625,57963,77378,19415,3.9,47,0
19,631172,113316,125784,12468,0.7,48,1
20,651871,19132,53054,33922,5.2,48,0
21,726811,71029,101028,29999,2.2,48,0
22,830180,94696,123523,28827,6.0,49,1
23,1091943,245015,285480,40465,1.0,49,0
0,36986,-2676,2097,4773,0.0,45,0
1,33838,-3991,1765,5756,0.8,45,0
2,31291,-3003,758,3761,0.9,45,0
3,28864,-2927,1468,4395,0.0,44,-1
4,29308,-235,2826,3061,0.0,44,0
5,28613,-903,1220,2123,0.0,44,0
6,27353,-1350,626,1976,0.0,44,0
7,25987,-1524,815,2339,0.0,44,0
8,25451,-749,544,1293,0.0,44,0
9,38615,7540,10330,2790,0.0,43,-1
10,45093,6479,9525,3046,1.4,43,0
11,49633,4495,7830,3335,0.0,43,0
12,60878,8706,14276,5570,0.0,43,0
13,61355,1383,5693,4310,0.0,43,0
14,60186,-1112,5066,6178,0.0,43,0
15,56893,-1808,3271,5079,0.0,43,0
16,56893,-1808,3271,5079,1.8,43,0
17,52088,-3810,2161,5971,0.0,43,0
18,47302,-4814,408,5222,0.0,43,0
19,44366,-3080,258,3338,0.0,43,0
20,41838,-2595,278,2873,2.5,43,0
21,39602,-2286,515,2801,0.0,43,0
22,38135,-1609,210,1819,0.0,43,0
23,36858,-1362,354,1716,1.5,43,0
0,10543,-709,922,1631,0.0,60,0
1,9412,-1756,665,2421,0.0,60,0
2,8507,-1307,391,1698,0.0,59,-1
3,7681,-1141,271,1412,0.0,59,0
4,7433,-490,276,766,0.0,58,-1
5,7166,-429,186,615,0.0,58,0
6,6894,-401,122,523,0.2,58,0
7,6845,-238,216,454,2.2,58,0
8,6839,-102,169,271,0.3,57,-1
9,6787,-77,183,260,5.2,57,0
10,8759,1739,2026,287,16.7,57,0
11,10690,1827,2393,566,21.3,57,0
12,79094,60898,65012,4114,16.9,57,0
13,142509,62770,71670,8900,11.8,57,0
14,307695,160439,179304,18865,4.5,58,1
15,355384,48051,94410,46359,0.5,58,0
16,355384,48051,94410,46359,0.5,58,0
17,262206,-80927,16117,97044,0.1,58,0
18,162792,-99920,936,100856,0.0,57,-1
19,120947,-42579,730,43309,0.4,56,-1
20,98627,-22704,567,23271,0.0,55,-1
21,79060,-19264,552,19816,0.0,54,-1
22,69968,-9990,276,10266,2.5,53,-1
23,68349,-1862,4869,6731,13.0,53,0
0,12720,-696,648,1344,8.0,45,0
1,178556,123297,145702,22405,2.4,45,0
2,283613,88397,115630,27233,1.5,45,0
3,406292,102337,152737,50400,2.0,46,1
4,578423,160144,188002,27858,4.3,46,0
5,612943,35865,62518,26653,0.7,47,1
6,561677,-47128,14171,61299,2.9,47,0
7,581171,12190,41099,28909,6.3,47,0
8,676269,86171,97414,11243,2.7,47,0
9,687212,23075,45074,21999,1.5,47,0
10,766143,72551,82513,9962,0.0,47,0
11,687878,-73025,16065,89090,0.0,48,1
12,556613,-128445,1699,130144,0.4,48,0
13,533891,-28505,7473,35978,2.0,47,-1
14,510644,-24353,10259,34612,2.3,47,0
15,439440,-22420,13034,35454,1.8,47,0
16,439440,-22420,13034,35454,3.0,47,0
17,430686,-17799,11039,28838,2.0,47,0
18,409497,-21284,4127,25411,1.9,46,-1
19,410077,-301,9792,10093,4.4,46,0
20,398862,-11636,6979,18615,1.6,46,0
21,394525,-3533,14345,17878,3.1,46,0
22,412425,14917,27880,12963,4.2,46,0
23,495717,77900,99705,21805,2.0,46,0
0,823,-119,111,230,0.0,60,0
1,721,-152,60,212,0.0,60,0
2,696,-60,49,109,0.0,60,0
3,738,-12,131,143,0.0,60,0
4,748,-14,77,91,0.0,60,0
5,733,-32,43,75,0.0,60,0
6,731,-15,45,60,0.0,60,0
7,747,-1,71,72,0.0,60,0
8,757,4,38,34,0.0,60,0
9,779,4,48,44,0.0,60,0
10,768,-14,22,36,0.0,60,0
11,776,3,21,18,0.0,60,0
12,802,14,49,35,0.0,60,0
13,802,-4,20,24,0.0,60,0
14,802,-7,36,43,0.0,60,0
15,809,0,31,31,0.0,60,0
16,809,0,31,31,0.0,60,0
17,819,-1,53,54,0.0,60,0
18,845,21,55,34,0.0,60,0
19,853,2,47,45,0.0,60,0
20,866,5,34,29,0.0,60,0
21,895,19,85,66,0.0,60,0
22,921,13,56,43,0.0,60,0
23,996,60,108,48,0.0,60,0
0,1061409,50916,159041,108125,2.3,45,0
1,1015076,-74542,136592,211134,0.0,45,0
2,902961,-124870,43293,168163,0.0,45,0
3,777537,-137106,36935,174041,0.0,44,-1
4,694530,-90028,22851,112879,0.0,44,0
5,652499,-50993,20146,71139,0.0,43,-1
6,625454,-30818,20229,51047,0.0,43,0
7,587693,-40400,25659,66059,0.0,43,0
8,577018,-17788,17581,35369,0.0,43,0
9,558015,-6954,25382,32336,0.0,43,0
10,553397,-6092,17382,23474,0.4,43,0
11,555406,1165,21768,20603,0.0,43,0
12,591110,27599,52670,25071,0.0,43,0
13,593216,3148,26521,23373,0.2,43,0
14,601214,6038,36682,30644,4.3,43,0
15,795857,84333,121339,37006,0.0,43,0
16,795857,84333,121339,37006,0.0,43,0
17,733181,-6733,63416,70149,0.5,43,0
18,738192,2655,42463,39808,0.0,43,0
19,717456,-21534,25568,47102,0.0,43,0
20,686455,-32194,15967,48161,0.0,43,0
21,664319,-25340,26337,51677,0.0,43,0
22,654062,-11315,21020,32335,0.0,43,0
23,661257,-910,45511,46421,0.0,43,0
0,25260,-1498,1933,3431,5.9,50,0
1,25292,-1041,3375,4416,0.4,50,0
2,24358,-1437,1814,3251,1.2,50,0
3,21940,-2801,1245,4046,2.5,50,0
4,21527,-928,1527,2455,2.8,50,0
5,21004,-806,974,1780,7.3,50,0
6,21584,279,1819,1540,3.6,49,-1
7,22805,816,2878,2062,3.5,49,0
8,23652,539,2060,1521,3.3,49,0
9,21352,-867,614,1481,1.8,49,0
10,18449,-2870,55,2925,0.0,49,0
11,17711,-855,269,1124,4.1,49,0
12,18023,113,964,851,1.4,49,0
13,17865,-208,440,648,1.6,49,0
14,17761,-198,647,845,2.2,49,0
15,19054,481,1408,927,4.4,49,0
16,19054,481,1408,927,2.0,49,0
17,18551,-437,694,1131,3.5,49,0
18,18170,-441,623,1064,1.9,49,0
19,18005,-240,521,761,1.6,49,0
20,17448,-636,220,856,0.0,49,0
21,16797,-719,365,1084,2.5,49,0
22,16515,-388,228,616,3.2,49,0
23,16890,259,875,616,0.0,49,0
0,17874,0,0,0,2.3,60,0
1,20236,-2091,1540,3631,0.1,60,0
2,19252,-2661,1476,2277,0.0,59,-1
3,29128,8826,11178,2352,9.6,59,0
4,89271,51128,65234,14106,9.1,59,0
5,303908,198243,214128,15885,8.3,60,1
6,332401,32225,65641,33416,9.0,60,0
7,281028,-51074,22565,73639,19.4,60,0
8,331745,37773,74546,36773,0.0,60,0
9,218952,-105579,3644,109223,0.0,60,0
10,107464,-26596,716,27312,0.0,59,-1
11,97632,-10267,895,11162,0.0,59,0
12,90015,-7983,826,8809,0.0,59,0
13,80717,-9129,715,9844,0.0,59,0
14,74346,-6685,56,6741,0.0,59,0
15,69773,-4742,358,5100,0.0,59,0
16,61441,-2908,166,3074,5.1,59,0
17,61441,-2908,166,3074,4.2,59,0
18,63731,1630,4738,3108,3.7,59,0
19,62734,-1126,1450,2576,8.2,59,0
20,70681,7277,8956,1679,2.9,59,0
21,70610,-353,3616,3969,9.5,59,0
22,68680,-2252,2931,5183,4.9,59,0
23,66537,-2539,1639,4178,2.0,59,0
24,75591,7937,11880,3943,0.0,59,0
0,25413,686,3758,3072,6.9,50,0
1,32286,3693,7499,3806,5.3,50,0
2,34728,1252,4513,3261,2.7,50,0
3,40928,3950,8427,4477,1.8,50,0
4,52526,9994,13112,3118,2.3,50,0
5,54073,1297,4921,3624,0.3,50,0
6,48787,-5213,1290,6503,2.7,50,0
7,55163,4110,7452,3342,2.4,50,0
8,53789,-929,2804,3733,6.0,50,0
9,51380,-285,2505,2790,2.2,50,0
10,44151,-7068,323,7391,0.0,50,0
11,45367,657,2801,2144,4.1,50,0
12,51523,5210,7287,2077,4.2,50,0
13,58384,6472,8980,2508,6.3,50,0
14,74513,14993,20223,5230,8.2,50,0
15,90797,4504,11284,6780,3.6,50,0
16,90797,4504,11284,6780,4.1,50,0
17,96140,5080,13524,8444,3.4,50,0
18,94035,-2308,4596,6904,2.7,50,0
19,108994,13644,16601,2957,4.3,50,0
20,110433,768,7774,7006,2.4,50,0
21,127740,15106,21644,6538,0.7,50,0
22,101620,-25317,3656,28973,0.0,50,0
23,70679,-30627,256,30883,0.0,50,0
0,104050,39937,54723,14786,5.6,60,0
1,109123,2870,24796,21926,2.9,60,0
2,88058,-21395,5557,26952,24.3,60,0
3,294610,177895,223870,45975,4.6,60,0
4,384478,86893,121952,35059,6.4,60,0
5,354508,-29036,39546,68582,13.0,60,0
6,345608,-10736,32906,43642,14.7,60,0
7,717477,328383,356951,28568,4.1,61,1
8,725709,28844,87216,58372,2.9,61,0
9,604512,-12245,48508,60753,5.0,61,0
10,633246,21247,59455,38208,9.9,61,0
11,612836,-19687,34348,54035,3.9,61,0
12,562974,-52776,32485,85261,20.1,61,0
13,594186,25893,68754,42861,4.5,61,0
14,615466,19380,72131,52751,9.5,61,0
15,886338,232687,298258,65571,3.1,61,0
16,886338,232687,298258,65571,11.7,61,0
17,979049,117896,201024,83128,16.8,61,0
18,1311988,323454,354725,31271,8.8,62,1
19,1428318,114950,172471,57521,9.1,63,1
20,1440375,7465,81612,74147,10.2,63,0
21,1790561,333914,393863,59949,0.9,64,1
22,1851381,59100,191282,132182,7.0,65,1
23,2191797,318364,438701,120337,7.3,65,0
0,2616,2052,2830,778,0.4,60,0
1,3286,400,1246,846,2.8,60,0
2,3422,-422,836,1258,2.3,60,0
3,3486,-287,512,799,0.1,60,0
4,3479,-305,264,569,0.7,59,-1
5,2811,-699,78,777,0.0,59,0
6,2664,-317,182,499,7.0,59,0
7,3501,573,812,239,1.2,59,0
8,3554,-33,293,326,1.9,59,0
9,4260,542,772,230,10.1,59,0
10,4704,344,677,333,16.5,59,0
11,13702,7450,8703,1253,10.7,59,0
12,25199,10934,13132,2198,2.7,59,0
13,27790,2060,7596,5536,9.5,59,0
14,43418,5646,10948,5302,2.5,59,0
15,43418,5646,10948,5302,8.5,59,0
16,57270,13483,21953,8470,5.9,59,0
17,51156,-6073,4877,10950,4.0,59,0
18,47861,-3663,3630,7293,2.0,59,0
19,39678,-8408,1460,9868,5.7,59,0
20,39974,-242,5591,5833,0.3,59,0
21,35503,-4929,1577,6506,9.5,59,0
22,106998,66693,74897,8204,1.1,59,0
0,0,0,0,0,0.0,45,0
1,1317,745,944,199,0.0,45,0
2,2710,595,1160,565,0.0,45,0
3,4020,837,1451,614,0.0,45,0
4,4690,312,1005,693,0.0,45,0
5,4819,-75,658,733,0.0,45,0
6,5233,1,786,785,0.0,45,0
7,5517,71,557,486,0.0,45,0
8,5731,56,512,456,3.0,45,0
9,6574,645,1006,361,0.0,45,0
10,6614,-43,447,490,0.0,45,0
11,6981,85,788,703,0.0,45,0
12,6995,-61,323,384,1.7,45,0
13,7023,-104,417,521,0.1,45,0
14,7426,-66,349,415,0.3,45,0
15,7426,-66,349,415,0.1,45,0
16,7346,-198,313,511,0.0,45,0
17,7171,-245,165,410,0.0,45,0
18,7051,-179,173,352,0.0,45,0
19,6939,-196,166,362,1.0,45,0
20,6947,-94,287,381,0.0,45,0
21,6904,-138,176,314,0.7,45,0
22,7143,98,440,342,2.3,45,0
0,0,0,0,0,0.0,55,0
1,119,85,101,16,0.1,55,0
2,211,57,98,41,0.0,55,0
3,248,-24,44,68,0.1,55,0
4,303,-1,39,40,0.2,55,0
5,387,11,65,54,0.4,55,0
0,0,0,0,0,0.0,45,0
1,66,33,47,14,0.0,45,0
0,0,0,0,0,0.0,45,0
1,62,45,56,11,0.0,45,0
0,78657,0,0,0,3.6,65,0
1,57682,-25783,2185,27968,0.8,65,0
2,45742,-13848,1340,15188,0.4,64,-1
3,42184,-5216,1748,6964,2.4,64,0
4,36915,-6062,1191,7253,0.5,63,-1
5,34871,-2589,1019,3608,5.4,63,0
6,33221,-2018,813,2831,3.2,63,0
7,32712,-1005,1667,2672,10.2,62,-1
8,31681,-1276,1300,2576,3.6,62,0
9,29242,-2472,269,2741,0.0,62,0
10,26016,-3234,102,3336,0.0,62,0
11,24114,-2048,78,2126,0.0,62,0
12,23388,-787,43,830,0.2,62,0
13,24628,1063,1526,463,5.5,62,0
14,24341,-434,577,1011,3.6,62,0
15,23684,-691,139,830,0.0,62,0
16,22915,-794,30,824,0.6,62,0
17,22419,-540,226,766,0.0,62,0
18,22023,-455,31,486,0.0,62,0
19,21468,-592,66,658,0.0,62,0
20,21368,-152,60,212,1.1,62,0
21,21377,-54,116,170,1.7,62,0
22,21528,58,253,195,0.5,62,0
23,21501,-146,241,387,6.3,62,0
24,21494,-108,186,294,1.3,62,0
0,10256,0,0,0,0.3,60,0
1,10665,-1344,510,1854,0.0,60,0
2,8573,-2499,328,2827,3.0,59,-1
3,7779,-1100,243,1343,0.4,59,0
4,7081,-962,183,1145,1.8,58,-1
5,6782,-446,143,589,2.4,58,0
6,6521,-389,88,477,7.1,58,0
7,7174,369,821,452,13.0,58,0
8,7068,-199,496,695,6.9,58,0
9,7754,494,1039,545,7.5,58,0
10,18795,7893,9192,1299,10.9,58,0
11,41085,21373,23861,2488,5.7,58,0
12,91339,48563,52629,4066,0.0,58,0
13,95310,3161,15709,12548,0.0,58,0
14,68097,-27031,2004,29035,1.9,58,0
15,54278,-14396,504,14900,7.2,58,0
16,43840,-10789,519,11308,0.0,58,0
17,30715,-8358,406,8764,0.0,58,0
18,28912,-6897,253,7150,2.4,58,0
19,26774,-3271,430,3701,9.3,58,0
20,23734,-3065,51,3116,13.6,58,0
21,23114,-722,478,1200,9.5,58,0
22,22958,-276,1059,1335,6.9,58,0
23,22738,-306,1704,2010,10.4,58,0
24,22726,-264,1502,1766,7.4,58,0
0,6355,0,0,0,0.0,50,0
1,5044,-1491,106,1597,0.0,50,0
2,4658,-701,228,929,0.0,50,0
3,3924,-857,131,988,0.0,49,-1
4,3201,-750,25,775,0.0,49,0
5,3066,-196,66,262,0.0,49,0
6,3043,-103,97,200,0.0,48,-1
7,2944,-128,85,213,0.0,48,0
8,2766,-205,75,280,0.0,48,0
9,2716,-74,42,116,0.0,48,0
10,2623,-113,41,154,0.0,48,0
11,2523,-111,12,123,0.0,48,0
12,2550,-1,64,65,0.0,48,0
13,2548,-8,47,55,0.0,48,0
14,2570,-12,83,95,0.0,48,0
15,2573,-15,55,70,4.8,48,0
16,2558,-35,49,84,0.9,48,0
17,2814,34,159,125,1.4,48,0
18,2651,9,93,84,0.2,48,0
19,2647,-37,55,92,0.3,48,0
20,2598,-61,28,89,0.0,48,0
21,2568,-38,27,65,0.0,48,0
22,2548,-39,29,68,0.0,48,0
23,2498,-60,33,93,0.0,48,0
24,2503,-19,34,53,0.0,48,0
0,51065,0,0,0,0.0,45,0
1,46103,-7122,1006,8128,0.5,45,0
2,41184,-6018,1241,7259,0.0,45,0
3,36993,-4781,740,5521,0.0,44,-1
4,33384,-3940,663,4603,1.6,44,0
5,32534,-1309,1211,2520,2.5,44,0
6,31601,-1079,650,1729,0.8,44,0
7,31064,-869,948,1817,4.0,44,0
8,30284,-869,742,1611,0.5,44,0
9,29837,-643,659,1302,0.0,43,-1
10,29136,-893,809,1702,0.0,43,0
11,28375,-837,504,1341,2.7,43,0
12,27883,-566,453,1019,0.0,43,0
13,27157,-765,319,1084,0.0,43,0
14,26183,-1051,368,1419,3.2,43,0
15,25986,-291,421,712,2.0,43,0
16,25873,-187,622,809,0.5,43,0
17,28711,183,2290,2107,2.0,42,-1
18,27316,829,2412,1583,1.4,42,0
19,30359,2887,5086,2199,0.0,42,0
20,29446,-819,817,1636,1.0,42,0
21,28627,-907,523,1430,4.1,42,0
22,33099,4116,5119,1003,1.6,42,0
23,35128,1756,4208,2452,7.0,42,0
24,48548,13052,16922,3870,7.7,42,0
0,531265,0,0,0,2.9,50,0
1,508280,-45744,11610,57354,2.0,50,0
2,510370,-14632,30378,45010,0.3,50,0
3,456061,-55557,6570,62127,1.8,50,0
4,411240,-50028,9703,59731,4.5,49,-1
5,300961,-108216,1182,109398,0.0,49,0
6,246312,-59148,100,59248,0.0,48,-1
7,211596,-35467,94,35561,0.0,48,0
8,203928,-9194,1941,11135,2.1,48,0
9,201220,-3655,2174,5829,1.5,48,0
10,198682,-3031,2608,5639,2.7,48,0
11,193847,-5291,1409,6700,2.3,48,0
12,192851,-1575,3086,4661,8.5,48,0
13,208698,14078,17445,3367,3.6,48,0
14,198284,-9302,2832,12134,8.8,48,0
15,199888,769,4925,4156,3.4,48,0
16,198641,-1512,4432,5944,7.6,48,0
17,201296,1105,10498,9393,0.9,48,0
18,193337,-5269,3328,8597,3.3,48,0
19,205972,8649,14652,6003,5.8,48,0
20,203822,-2108,5000,7108,3.9,48,0
21,205977,1625,5452,3827,6.6,48,0
22,247405,38709,42299,3590,6.1,48,0
23,304090,50972,63731,12759,5.1,48,0
24,451571,141704,154117,12413,5.4,49,1
0,22063,0,0,0,0.0,50,0
1,14656,-7348,367,7715,0.0,50,0
2,11125,-3949,10186,14135,0.0,49,-1
3,9214,-2100,114,2214,0.0,49,0
4,7864,-1403,156,1559,0.0,49,0
5,7191,-754,130,884,0.0,48,-1
6,6814,-451,170,621,0.0,48,0
7,6439,-383,77,460,0.0,48,0
8,6143,-308,219,527,0.0,48,0
9,5932,-225,91,316,0.0,48,0
10,5785,-158,65,223,0.0,48,0
11,5659,-130,71,201,0.0,48,0
12,5578,-88,33,121,0.0,48,0
13,5534,-52,60,112,0.0,48,0
14,5419,-118,59,177,0.0,48,0
15,5380,-48,41,89,0.0,48,0
16,5368,-18,103,121,0.0,48,0
17,5384,-35,154,189,0.0,48,0
18,5324,-29,75,104,0.0,48,0
19,5254,-63,88,151,0.0,48,0
20,5279,18,89,71,0.0,48,0
21,5284,-2,112,114,0.0,48,0
22,5274,-14,121,135,0.0,48,0
23,5356,66,270,204,0.0,48,0
24,5233,-129,73,202,0.0,48,0
0,2728,0,0,0,5.4,50,0
1,4539,596,1554,958,2.3,50,0
2,5890,658,2011,1353,13.1,50,0
3,52692,40144,51237,11093,6.6,50,0
4,73126,18168,35647,17479,6.8,50,0
5,88440,13758,25420,11662,2.9,50,0
6,86542,-1636,10361,11997,3.1,50,0
7,71053,-14790,4162,18952,0.0,50,0
8,63645,-8068,3829,11897,7.2,50,0
9,78959,13213,20491,7278,3.0,50,0
10,97168,15765,24756,8991,3.0,50,0
11,98590,2768,11698,8930,6.9,50,0
12,104954,5720,13694,7974,3.3,50,0
13,110975,5234,14012,8778,11.4,50,0
14,116112,4223,16793,12570,3.0,50,0
15,118433,1934,10156,8222,0.6,50,0
16,115849,-3007,11374,14381,8.4,50,0
17,107236,-4697,15013,19710,1.0,50,0
18,98670,-11430,8341,19771,2.7,50,0
19,97540,-5042,10034,15076,7.6,50,0
20,83060,-14402,1992,16394,8.9,50,0
21,77265,-6243,2246,8489,3.3,50,0
22,61504,-15709,791,16500,0.0,50,0
23,46827,-14431,210,14641,0.0,50,0
24,41569,-5860,117,5977,0.0,50,0
0,187445,0,0,0,2.8,45,0
1,171745,-17741,2892,20633,1.1,45,0
2,173190,-4037,15990,20027,3.0,45,0
3,163327,-10365,4263,14628,3.2,45,0
4,152098,-12528,6669,19197,6.5,45,0
5,148601,-4912,5979,10891,1.8,45,0
6,139948,-8627,826,9453,4.0,45,0
7,140229,-1722,6272,7994,0.8,44,-1
8,135354,-4281,4367,8648,2.3,44,0
9,131297,-4479,1922,6401,1.6,44,0
10,130815,-1258,4287,5545,1.8,44,0
11,127371,-3445,1964,5409,0.0,44,0
12,125038,-2686,2600,5286,3.3,44,0
13,136912,10711,13571,2860,4.9,44,0
14,132475,-3951,4698,8649,5.5,44,0
15,128464,-4201,2253,6454,2.0,44,0
16,126359,-2435,3959,6394,4.9,44,0
17,119129,-4386,6393,10779,3.1,44,0
18,112008,-7777,3074,10851,2.6,44,0
19,115557,29,6293,6264,1.3,44,0
20,111903,-3618,1383,5001,2.6,44,0
21,111472,-591,1959,2550,2.9,44,0
22,117782,5766,7986,2220,2.5,44,0
23,103880,-12620,607,13227,0.0,44,0
24,96764,-8167,154,8321,0.0,44,0
0,22681,0,0,0,0.0,45,0
1,21500,-3610,845,4455,0.0,45,0
2,17976,-4280,733,5013,0.0,44,-1
3,15576,-2785,379,3164,2.6,44,0
4,14803,-1271,1151,2422,0.0,43,-1
5,14385,-598,869,1467,1.8,43,0
6,15224,484,1608,1124,1.3,43,0
7,16626,960,2145,1185,6.2,43,0
8,29407,10419,13305,2886,2.3,43,0
9,30947,2160,5031,2871,2.8,43,0
10,36951,4444,7361,2917,2.0,43,0
11,35756,71,2831,2760,2.7,43,0
12,38765,2625,4678,2053,0.0,43,0
13,38390,-281,2324,2605,0.8,43,0
14,38092,-641,3150,3791,0.0,43,0
15,35712,-2338,1063,3401,6.0,43,0
16,34350,-1539,1364,2903,6.1,43,0
17,31465,-1905,1862,3767,1.7,43,0
18,30267,-1979,999,2978,2.4,43,0
19,33436,2213,4964,2751,7.3,43,0
20,35516,1904,3898,1994,2.8,43,0
21,36028,492,2783,2291,0.0,43,0
22,32897,-3091,906,3997,3.9,43,0
23,37149,3641,6162,2521,9.4,43,0
24,52600,14789,18359,3570,12.0,43,0
0,102974,0,0,0,0.7,65,0
1,101960,-9748,7825,17573,16.3,65,0
2,160211,37254,67121,29867,14.1,65,0
3,281184,99742,141065,41323,11.9,65,0
4,448156,144900,210560,65660,10.1,66,1
5,525930,71716,127443,55727,3.3,66,0
6,408386,-108481,12029,120510,0.0,66,0
7,366776,-47818,28616,76434,6.2,65,-1
8,287689,-77037,9179,86216,3.0,64,-1
9,244824,-46820,3493,50313,1.8,63,-1
10,184328,-60176,1302,61478,1.9,62,-1
11,167369,-21165,2602,23767,4.7,62,0
12,169988,729,9837,9108,0.0,61,-1
13,165738,-4362,9236,13598,7.2,61,0
14,150630,-14941,2844,17785,8.7,61,0
15,153088,1321,6966,5645,0.1,61,0
16,152478,-1058,8092,9150,7.7,61,0
17,200504,20158,35789,15631,0.8,61,0
18,172333,774,17880,17106,8.5,61,0
19,261383,80086,100411,20325,8.4,61,0
20,247211,-12579,15932,28511,5.1,61,0
21,239618,-8588,14179,22767,3.6,61,0
22,242636,1652,20924,19272,2.4,61,0
23,232066,-10431,22209,32640,7.0,61,0
24,244270,9773,29774,20001,8.3,61,0
0,24123,0,0,0,7.9,60,0
1,47806,11942,19867,7925,7.5,60,0
2,71199,17274,34630,17356,5.1,60,0
3,138726,59207,81893,22686,5.9,60,0
4,174078,30407,65427,35020,4.1,60,0
5,175554,1052,25479,24427,2.8,60,0
6,147073,-28176,4842,33018,4.5,60,0
7,139788,-10525,12320,22845,0.0,60,0
8,85200,-51022,419,51441,0.0,60,0
9,72928,-15381,809,16190,0.2,60,0
10,67198,-6503,1892,8395,3.6,59,-1
11,61917,-5749,1094,6843,0.0,59,0
12,59240,-2993,1822,4815,5.6,59,0
13,57980,-1454,2172,3626,12.3,58,-1
14,54155,-3837,744,4581,7.4,58,0
15,52287,-2072,610,2682,0.1,58,0
16,49833,-2588,707,3295,11.4,57,-1
17,52936,1312,4661,3349,5.1,57,0
18,50808,-587,2620,3207,1.2,57,0
19,50991,-544,3207,3751,10.8,57,0
20,47843,-3151,271,3422,10.9,57,0
21,48587,461,1936,1475,6.9,57,0
22,57691,8437,10383,1946,0.3,57,0
23,53568,-4017,3361,7378,10.7,57,0
24,53939,-241,3747,3988,11.2,57,0
0,3104,0,0,0,0.5,55,0
1,3804,-235,305,540,3.0,55,0
2,3886,-348,304,652,6.5,55,0
3,3920,-247,386,633,0.0,55,0
4,3195,-774,52,826,0.0,54,-1
5,2939,-309,20,329,0.0,54,0
6,2749,-208,21,229,0.0,54,0
7,2559,-195,21,216,0.3,54,0
8,2629,-17,75,92,0.0,54,0
9,2633,-29,37,66,4.0,54,0
10,2671,-6,73,79,0.6,54,0
11,2675,-24,51,75,4.3,54,0
12,2721,16,74,58,0.0,54,0
13,2722,-18,59,77,6.3,54,0
14,2738,-42,68,110,0.0,54,0
15,2735,-16,47,63,3.3,54,0
16,2732,-23,46,69,0.0,54,0
17,2757,-59,74,133,0.0,54,0
18,2658,-71,15,86,0.0,54,0
19,2643,-29,84,113,0.0,54,0
20,2550,-95,14,109,0.0,54,0
21,2671,113,162,49,0.0,54,0
22,2554,-117,32,149,0.0,54,0
23,2525,-30,61,91,0.0,54,0
24,2509,-22,43,65,2.0,54,0
0,133,0,0,0,0.0,55,0
1,163,-6,34,40,0.0,55,0
2,161,-9,9654,9663,0.0,55,0
3,155,-14,19,33,0.0,55,0
4,177,14,50,36,0.0,55,0
5,161,-18,24,42,0.0,55,0
6,165,0,16,16,0.0,55,0
7,166,0,13,13,0.0,55,0
8,177,9,26,17,0.0,55,0
9,197,14,48,34,0.0,55,0
10,177,-15,16,31,0.0,55,0
11,181,3,18,15,0.0,55,0
12,174,-8,7,15,0.0,55,0
13,175,2,11,9,0.0,55,0
14,175,-1,8,9,0.0,55,0
15,185,9,16,7,0.0,55,0
16,194,7,30,23,0.0,55,0
17,203,4,31,27,0.0,55,0
18,211,10,20,10,0.0,55,0
19,273,52,94,42,0.0,55,0
20,236,-39,23,62,0.0,55,0
21,267,10,27,17,0.0,55,0
22,297,-9,24,33,0.0,55,0
23,349,-9,20,29,0.0,55,0
24,400,-3,21,24,0.0,55,0
0,103827,0,0,0,1.5,45,0
1,96397,-12682,4037,16719,1.7,45,0
2,111432,7469,21069,13600,4.2,45,0
3,106517,-5843,5085,10928,2.9,45,0
4,101660,-6696,6049,12745,2.4,45,0
5,101629,-1281,4856,6137,1.6,45,0
6,97883,-3975,1837,5812,1.7,45,0
7,98103,-1178,3952,5130,1.5,45,0
8,94550,-3198,2380,5578,1.4,45,0
9,92411,-2620,1596,4216,4.2,45,0
10,93521,224,3871,3647,0.4,44,-1
11,91951,-1667,2053,3720,2.0,44,0
12,93842,1392,4114,2722,2.2,44,0
13,105178,10462,12427,1965,0.7,44,0
14,103352,-1695,5049,6744,2.5,44,0
15,101075,-2455,2382,4837,0.0,44,0
16,96878,-4406,2642,7048,2.5,44,0
17,88530,-4293,4095,8388,0.9,44,0
18,86965,-4888,2601,7489,3.6,44,0
19,90431,1223,6418,5195,3.1,44,0
20,91375,720,4446,3726,5.0,44,0
21,96232,4422,6832,2410,0.9,44,0
22,121177,23598,26611,3013,2.0,44,0
23,131595,10030,19844,9814,0.9,44,0
24,171597,37506,46868,9362,3.6,44,0
0,269810,0,0,0,1.7,45,0
1,314988,21711,52550,30839,0.3,45,0
2,242593,-68822,13774,82596,0.0,45,0
3,233951,-13257,10162,23419,7.1,45,0
4,259023,17783,66445,48662,5.3,45,0
5,275399,14690,38217,23527,0.8,45,0
6,275283,-101,16177,16278,1.8,45,0
7,269346,-6519,11749,18268,2.7,45,0
8,255868,-13132,15556,28688,2.0,45,0
9,253824,-3829,10247,14076,2.2,45,0
10,246180,-7826,10391,18217,2.9,45,0
11,245166,-2474,8949,11423,3.6,45,0
12,243900,-1471,7662,9133,3.7,45,0
13,240163,-4293,6001,10294,3.8,45,0
14,247150,5362,19066,13704,3.6,45,0
15,236812,-10222,8752,18974,4.2,45,0
16,228627,-8586,8956,17542,0.8,45,0
17,139642,-39916,2376,42292,0.0,45,0
18,170127,-20481,3803,24284,0.5,45,0
19,161597,-12243,3273,15516,3.8,45,0
20,142618,-19038,1060,20098,1.5,45,0
21,135053,-7822,1290,9112,2.3,44,-1
22,129671,-5593,1709,7302,2.3,44,0
23,124122,-5496,3847,9343,1.9,44,0
24,120336,-4372,3096,7468,1.5,44,0
0,114860,0,0,0,8.1,45,0
1,255961,95722,121019,25297,2.7,45,0
2,449371,173130,246717,73587,1.5,46,1
3,710031,224217,255139,30922,2.3,46,0
4,723139,20621,114182,93561,8.6,47,1
5,833490,88416,115150,26734,2.0,47,0
6,817558,-12305,29803,42108,6.0,47,0
7,859486,33385,62032,28647,8.6,47,0
8,977918,104933,128238,23305,3.4,48,1
9,809912,-152538,6161,158699,0.0,48,0
10,856524,28696,50604,21908,3.1,48,0
11,858192,141,23592,23451,0.0,48,0
12,812780,-45120,12994,58114,0.4,48,0
13,842102,23004,46318,23314,0.0,48,0
14,644473,-190845,3344,194189,0.0,48,0
15,546334,-102849,739,103588,0.0,47,-1
16,446360,-101679,1160,102839,0.0,47,0
17,319223,-65922,1716,67638,0.0,47,0
18,319542,-61471,290,61761,0.0,47,0
19,283498,-44211,367,44578,0.0,47,0
20,260056,-23835,172,24007,0.0,46,-1
21,244709,-15500,364,15864,0.0,46,0
22,230631,-14217,191,14408,0.0,46,0
23,217553,-12671,276,12947,0.0,46,0
24,211706,-6527,434,6961,0.0,46,0
0,32205,0,0,0,3.4,55,0
1,35030,-1161,5332,6493,6.9,55,0
2,55356,13526,26823,13297,1.9,55,0
3,55125,-1311,10399,11710,0.7,55,0
4,46774,-8992,5860,14852,3.0,55,0
5,50818,2053,9519,7466,0.0,55,0
6,43547,-7045,1470,8515,0.0,55,0
7,39808,-4140,2117,6257,0.0,54,-1
8,33468,-6056,967,7023,0.0,54,0
9,31760,-2355,591,2946,4.0,53,-1
10,35089,2280,4597,2317,3.8,53,0
11,34652,-72,2757,2829,0.2,53,0
12,33931,-829,1380,2209,0.0,53,0
13,32454,-1589,979,2568,4.8,53,0
14,31512,-1071,1440,2511,0.0,53,0
15,29667,-1854,255,2109,0.0,53,0
16,28722,-1081,717,1798,8.7,52,-1
17,25820,-2045,1228,3273,0.0,52,0
18,25125,-1502,135,1637,0.0,52,0
19,23575,-1723,133,1856,0.0,52,0
20,23710,39,669,630,1.9,52,0
21,23925,150,778,628,0.2,52,0
22,24055,41,821,780,1.5,52,0
23,24669,449,1576,1127,0.0,52,0
24,24472,-211,876,1087,0.0,52,0
0,21938,0,0,0,5.4,45,0
1,34504,7527,13842,6315,2.3,45,0
2,70040,28663,47799,19136,5.5,45,0
3,98255,24857,40880,16023,2.7,45,0
4,86018,-9491,6402,15893,0.0,45,0
5,79732,-7334,2151,9485,0.2,45,0
6,74348,-5905,1030,6935,0.0,45,0
7,67447,-6800,531,7331,0.0,45,0
8,59934,-7171,521,7692,0.0,45,0
9,56910,-3877,386,4263,0.0,45,0
10,51553,-5169,393,5562,0.0,44,-1
11,49816,-2426,356,2782,1.4,44,0
12,48178,-1730,315,2045,1.3,44,0
13,47890,-569,1537,2106,0.0,43,-1
14,63681,12725,16539,3814,0.8,43,0
15,75558,11803,16352,4549,0.0,43,0
16,80893,5680,15357,9677,0.0,43,0
17,77125,-4464,9286,13750,0.0,43,0
18,66710,-9199,1159,10358,0.0,43,0
19,62151,-5794,2319,8113,0.0,43,0
20,54475,-7693,384,8077,0.0,43,0
21,50134,-4437,234,4671,9.2,43,0
22,49594,-785,1996,2781,0.0,43,0
23,46521,-2961,1227,4188,1.4,43,0
24,47524,337,3468,3131,2.4,42,-1
0,3939,0,0,0,0.0,55,0
1,4108,-533,156,689,0.0,55,0
2,3458,-864,83,947,0.0,54,-1
3,3108,-443,93,536,0.0,54,0
4,2952,-272,84,356,4.4,53,-1
5,4136,832,1142,310,0.7,53,0
6,3878,-234,194,428,0.2,53,0
7,4072,59,450,391,0.0,53,0
8,3538,-524,128,652,0.0,53,0
9,3269,-293,70,363,0.0,53,0
10,3040,-244,48,292,0.0,53,0
11,2947,-115,20,135,1.0,53,0
12,2906,-50,29,79,0.0,53,0
13,2915,-22,43,65,0.0,53,0
14,2875,-65,34,99,0.0,53,0
15,2863,-35,22,57,2.2,53,0
16,2854,-32,29,61,0.0,53,0
17,2882,-38,56,94,3.1,53,0
18,2885,1,65,64,5.0,53,0
19,3176,240,384,144,4.2,53,0
20,3029,-151,30,181,8.8,53,0
21,3036,-14,93,107,0.0,53,0
22,2916,-129,26,155,2.5,53,0
23,3026,78,196,118,7.1,53,0
24,3122,68,185,117,4.2,53,0
0,107597,0,0,0,0.0,40,0
1,101857,-9208,2437,11645,0.0,40,0
2,96007,-7810,2973,10783,0.0,40,0
3,93659,-3823,2286,6109,0.0,40,0
4,89181,-5932,3493,9425,0.0,40,0
5,89200,-946,3506,4452,0.0,40,0
6,89041,-488,1878,2366,0.0,40,0
7,87273,-1754,808,2562,0.0,40,0
8,85501,-2157,1466,3623,0.0,40,0
9,84594,-893,939,1832,0.0,40,0
10,86627,-313,1928,2241,0.0,40,0
11,88037,2135,3315,1180,0.0,40,0
12,89813,1331,2313,982,0.0,40,0
13,90681,910,2162,1252,0.0,40,0
14,93926,2116,3706,1590,0.0,40,0
15,93880,-1,2390,2391,0.0,40,0
16,94735,697,3159,2462,0.0,40,0
17,132214,2567,6708,4141,0.0,40,0
18,102734,1510,5082,3572,0.0,40,0
19,100106,335,3657,3322,0.0,40,0
20,100945,624,2318,1694,0.0,40,0
21,101541,487,1974,1487,0.0,40,0
22,100583,-1052,1353,2405,0.0,40,0
23,99097,-1546,1771,3317,0.0,40,0
24,97369,-1936,666,2602,0.0,40,0
0,0,0,0,0,0.0,40,0
1,11147,5600,6959,1359,0.0,40,0
2,27517,11160,16637,5477,0.0,40,0
3,35099,5263,7664,2401,0.0,40,0
4,49960,11454,15803,4349,0.0,40,0
5,56160,6032,8101,2069,0.0,40,0
6,57281,1140,2720,1580,0.0,40,0
7,57914,227,2066,1839,0.0,40,0
8,62011,2988,4790,1802,0.0,40,0
9,62823,925,2370,1445,0.0,40,0
10,61358,-1768,1338,3106,0.0,40,0
11,61198,-57,995,1052,0.0,40,0
12,61347,-3,774,777,0.0,40,0
13,61026,-385,903,1288,0.0,40,0
14,61648,280,1339,1059,0.0,40,0
15,61584,-39,1035,1074,0.0,40,0
16,60261,-1425,1294,2719,0.0,40,0
17,79814,-972,2917,3889,0.0,40,0
18,58317,-1789,2145,3934,0.0,40,0
19,56736,-1289,1343,2632,0.0,40,0
20,55935,-840,630,1470,0.0,40,0
21,55565,-433,600,1033,0.0,40,0
22,54190,-1433,365,1798,0.0,40,0
23,52006,-2105,505,2610,0.0,40,0
24,50478,-1727,238,1965,0.0,40,0
0,462,244,301,57,0.0,50,0
1,1525,538,827,289,0.0,50,0
2,1788,-48,328,376,0.0,50,0
3,1983,-19,307,326,0.0,50,0
4,2251,-40,370,410,0.0,50,0
5,2343,-50,223,273,0.0,50,0
6,2568,22,316,294,0.0,50,0
7,2779,32,338,306,0.0,50,0
8,2932,47,274,227,0.0,50,0
9,2996,-51,195,246,1.8,50,0
10,3587,309,690,381,0.0,50,0
11,3719,47,299,252,0.0,50,0
12,3883,47,421,374,5.0,50,0
13,6597,777,1689,912,0.0,50,0
14,5357,298,916,618,0.0,50,0
15,5381,-61,832,893,0.0,50,0
16,5416,-32,430,462,0.0,50,0
17,5512,12,532,520,0.0,50,0
18,5765,88,654,566,0.0,50,0
19,6326,320,1177,857,0.0,50,0
20,6531,115,877,762,0.0,50,0
0,876,680,917,237,0.0,55,0
1,1352,295,578,283,0.3,55,0
2,2176,576,979,403,10.7,55,0
3,4233,1550,2438,888,9.2,55,0
4,14981,9307,11314,2007,5.3,55,0
5,61673,40103,44957,4854,4.2,55,0
6,71901,13605,24498,10893,2.0,55,0
7,91904,18023,26648,8625,2.6,55,0
8,106188,13679,23928,10249,8.7,55,0
9,122881,14243,30222,15979,3.3,55,0
10,120735,-1919,14391,16310,0.0,55,0
11,90999,-29407,4436,33843,0.0,55,0
12,46753,-24732,1506,26238,0.0,55,0
13,44079,-22758,166,22924,0.0,55,0
14,33347,-13048,129,13177,0.0,55,0
15,27761,-5720,81,5801,0.0,55,0
16,24022,-3800,103,3903,0.0,55,0
17,21346,-2693,156,2849,1.0,55,0
18,21894,247,2241,1994,3.5,55,0
19,21948,-225,1618,1843,7.7,55,0
0,0,0,0,0,1.9,45,0
1,1558,1024,1203,179,0.0,45,0
2,1291,-327,146,473,0.0,45,0
3,1764,250,523,273,0.0,44,-1
4,2069,179,493,314,0.0,44,0
5,2051,-41,153,194,0.0,44,0
6,2024,-90,71,161,3.7,44,0
7,16321,13606,14023,417,1.3,44,0
8,26981,10053,12414,2361,2.1,44,0
9,33161,6047,8919,2872,2.0,44,0
10,45818,12160,16449,4289,1.8,44,0
11,83304,10458,19892,9434,3.3,44,0
12,65931,10793,21265,10472,1.9,44,0
13,94469,25596,35121,9525,1.9,44,0
14,102778,8166,14231,6065,2.8,44,0
15,117088,13185,17026,3841,0.9,44,0
16,179633,58636,62559,3923,4.4,45,1
17,194082,12539,26558,14019,0.9,45,0
18,228267,30179,40554,10375,0.4,45,0
0,1431,964,1050,86,2.4,55,0
1,3437,2248,2641,393,0.1,55,0
2,3604,109,914,805,0.0,55,0
3,2818,-819,129,948,0.0,54,-1
4,2442,-419,88,507,0.0,53,-1
5,2097,-385,67,452,0.0,52,-1
6,1792,-333,49,382,0.0,51,-1
7,1645,-191,43,234,0.0,51,0
0,288,161,174,13,0.0,50,0
1,269,37,74,37,0.0,50,0
2,349,56,116,60,0.0,50,0
3,379,9,42,33,0.0,50,0
4,388,-12,26,38,0.0,50,0
5,435,2,51,49,0.0,50,0
6,510,19,75,56,0.0,50,0
7,549,-1,53,54,0.0,50,0
0,0,0,0,0,0.2,45,0
1,88,63,77,14,0.0,45,0
2,94,-6,42,48,0.0,45,0
3,96,-5,14,19,0.0,45,0
4,135,20,31,11,0.0,45,0
5,152,2,37,35,0.0,45,0
6,214,33,72,39,0.0,45,0
7,232,-3,42,45,0.0,45,0
0,0,0,0,0,0.0,45,0
1,41,26,34,8,0.0,45,0
2,74,10,27,17,0.0,45,0
3,79,-2,14,16,0.0,45,0
4,97,11,27,16,0.0,45,0
5,121,3,13,10,0.0,45,0
6,161,18,53,35,0.0,45,0
7,164,-6,29,35,0.0,45,0
0,0,0,0,0,0.0,45,0
1,64,39,54,15,0.0,45,0
2,121,44,71,27,0.0,45,0
3,126,-11,35,46,0.0,45,0
4,159,20,45,25,0.0,45,0
5,174,-8,27,35,0.0,45,0
6,262,55,111,56,0.0,45,0
7,274,-4,54,58,0.0,45,0
0,0,0,0,0,0.0,40,0
1,200,170,182,12,0.0,40,0
2,699,384,485,101,0.0,40,0
3,3402,2439,2892,453,0.0,39,-1
0,0,0,0,0,0.0,45,0
1,135,102,118,16,0.0,45,0
2,329,111,182,71,0.0,45,0
3,408,20,99,79,0.0,45,0
0,55,46,51,5,0.0,50,0
1,145,50,82,32,0.0,50,0
2,168,2,32,30,0.0,50,0
0,849631,0,0,0,0.0,45,0
1,635661,-110033,6747,140182,0.0,45,0
2,612961,-22133,4637,26770,3.1,45,0
3,660276,18947,82706,63759,1.7,44,-1
4,608815,-50184,55135,105319,0.0,44,0
5,581869,-30849,30083,60932,0.0,44,0
6,553855,-27812,9334,37146,0.5,44,0
7,522809,-30944,5171,36115,0.0,44,0
8,447050,-69110,1497,70607,0.0,44,0
9,436234,-20984,8346,29330,0.0,43,-1
10,407243,-27265,9337,36602,0.0,43,0
11,395373,-14144,5773,19917,0.0,43,0
12,384661,-10744,3839,14583,0.0,43,0
13,371672,-13321,2657,15978,0.0,43,0
14,373786,-1051,13117,14168,2.5,43,0
15,373178,-697,11517,12214,0.0,43,0
16,381555,-8369,18951,27320,0.0,43,0
17,355828,-10956,11913,22869,0.0,43,0
18,355828,-10956,11913,22869,0.0,43,0
19,338104,-15495,8445,23940,0.0,43,0
20,314165,-23942,2389,26331,0.0,43,0
21,300035,-14479,813,15292,0.0,43,0
22,292132,-8725,4046,12771,0.0,42,-1
23,285408,-7350,7638,14988,0.0,42,0
24,285408,-7350,7638,14988,0.0,42,0
25,276965,-9043,3151,12194,0.0,42,0
26,268724,-8902,3402,12304,0.2,42,0
0,347655,-44155,7804,51959,0.0,55,0
1,256219,-91242,1213,92455,0.0,55,0
2,217072,-43754,1677,45431,6.4,54,-1
3,207302,-14754,8172,22926,3.5,54,0
4,196759,-9799,2562,12361,6.0,54,0
5,191346,-6542,2440,8982,2.2,54,0
6,185975,-6522,3987,10509,2.0,54,0
7,188987,238,7944,7706,3.1,54,0
8,182714,-4777,2005,6782,1.7,54,0
9,177436,-5752,3194,8946,0.9,53,-1
10,172185,-5884,1225,7109,3.5,53,0
11,170888,-1749,1475,3224,4.2,53,0
12,172544,1148,3929,2781,3.1,53,0
13,172199,-684,4998,5682,4.8,53,0
14,186017,12170,16198,4028,3.1,53,0
15,187048,-8171,8566,16737,4.1,53,0
16,186843,-5727,4053,9780,2.1,53,0
17,186843,-5727,4053,9780,3.4,53,0
18,183377,-5211,3571,8782,1.4,53,0
19,177332,-6223,1571,7794,2.9,53,0
20,174486,-3169,1632,4801,2.4,53,0
21,185806,10290,15022,4732,7.7,53,0
22,274356,69554,78382,8828,2.3,53,0
23,274356,69554,78382,8828,2.0,53,0
24,255535,-2014,13132,15146,1.9,53,0
25,237558,-17645,11255,28900,3.6,53,0
0,38923,-815,3415,4230,1.9,45,0
1,38080,-1879,4011,5890,2.4,45,0
2,35951,-2642,1198,3840,0.8,45,0
3,33744,-2741,1453,4194,0.0,45,0
4,27153,-6408,183,6591,0.0,45,0
5,23035,-4357,52,4409,0.0,45,0
6,20774,-2352,121,2473,0.0,45,0
7,19041,-1786,100,1886,0.0,45,0
8,18286,-887,91,978,0.0,45,0
9,16632,-1624,38,1662,0.0,45,0
10,15732,-1021,18,1039,0.0,45,0
11,15037,-710,11,721,0.0,45,0
12,14631,-456,82,538,0.0,45,0
13,14442,-322,227,549,0.0,45,0
14,14304,-200,173,373,0.0,45,0
15,14013,-280,307,587,0.0,45,0
16,13713,-248,172,420,0.0,44,-1
17,13713,-248,172,420,0.0,44,0
18,13512,-253,154,407,0.0,44,0
19,13363,-178,81,259,0.0,44,0
20,13255,-139,69,208,0.0,44,0
21,13177,-118,110,228,0.0,44,0
22,13133,-104,295,399,0.8,44,0
23,13133,-104,295,399,0.0,44,0
24,13098,-63,154,217,0.0,44,0
25,12953,-185,107,292,0.0,44,0
0,85013,-1476,9662,11138,1.7,45,0
1,75005,-11025,6425,17450,0.0,45,0
2,61630,-13830,535,14365,0.0,45,0
3,50162,-12016,572,12588,0.9,44,-1
4,45235,-5362,868,6230,0.0,44,0
5,37749,-7591,117,7708,0.0,44,0
6,30156,-7631,60,7691,0.0,43,-1
7,25400,-4695,78,4773,0.0,43,0
8,24713,-1021,195,1216,1.8,43,0
9,23995,-812,327,1139,0.0,43,0
10,23183,-903,200,1103,0.0,43,0
11,22537,-691,150,841,0.0,43,0
12,21948,-636,143,779,0.0,43,0
13,21594,-460,514,974,2.3,43,0
14,22352,625,1428,803,1.1,43,0
15,42629,1911,7529,5618,0.7,43,0
16,44545,2567,8015,5448,1.9,43,0
17,44545,2567,8015,5448,1.7,43,0
18,40750,-2316,2525,4841,6.0,43,0
19,38635,-2179,1104,3283,1.4,43,0
20,37376,-1330,607,1937,1.6,43,0
21,39954,2408,4168,1760,3.1,43,0
22,106285,61525,65194,3669,2.2,43,0
23,106285,61525,65194,3669,0.0,43,0
24,80485,-21284,2943,24227,0.0,43,0
25,50035,-29518,153,29671,0.0,43,0
0,1333,-295,45,340,0.0,50,0
1,1200,-170,9641,9811,0.0,50,0
2,1129,-84,20,104,0.0,50,0
3,1176,29,104,75,0.0,50,0
4,1113,-64,33,97,0.0,50,0
5,1092,-23,26,49,0.0,50,0
6,1097,-2,33,35,0.0,50,0
7,1091,-8,44,52,0.0,50,0
8,1166,60,105,45,0.0,50,0
9,1124,-41,65,106,0.0,50,0
10,1236,108,174,66,0.0,50,0
11,1147,-90,4,94,0.0,50,0
12,1135,-13,10,23,0.0,50,0
13,1120,-18,11,29,0.0,50,0
14,1119,-3,6,9,0.0,50,0
15,1198,23,60,37,0.0,50,0
16,1174,15,50,35,0.0,50,0
17,1174,15,50,35,0.0,50,0
18,1239,14,64,50,1.6,50,0
19,1243,-9,28,37,0.8,50,0
20,1286,14,36,22,1.0,50,0
21,1352,19,59,40,4.3,50,0
22,1485,82,172,90,2.5,50,0
23,1485,82,172,90,0.9,50,0
24,1534,34,106,72,2.7,50,0
25,1588,18,115,97,0.9,50,0
0,15118,-563,881,1444,3.9,45,0
1,15661,-584,1496,2080,2.9,45,0
2,15833,-445,845,1290,1.1,45,0
3,16390,-52,1605,1657,0.8,45,0
4,17251,443,1533,1090,1.7,45,0
5,18056,380,1367,987,1.8,45,0
6,18176,-261,1128,1389,0.0,45,0
7,17083,-1271,455,1726,0.0,45,0
8,16322,-935,195,1130,0.0,45,0
9,15492,-871,205,1076,0.0,44,-1
10,15031,-623,166,789,0.0,44,0
11,14687,-421,119,540,0.0,44,0
12,14338,-408,124,532,0.0,44,0
13,14091,-339,272,611,0.0,44,0
14,13974,-196,199,395,0.0,43,-1
15,13117,-530,299,829,0.0,43,0
16,13209,-188,184,372,0.0,43,0
17,13209,-188,184,372,0.0,43,0
18,13067,-220,203,423,0.0,43,0
19,12980,-147,114,261,0.0,43,0
20,12865,-157,85,242,0.0,43,0
21,12782,-137,108,245,0.0,43,0
22,12766,-115,268,383,0.7,43,0
23,12766,-115,268,383,1.1,43,0
24,12875,62,326,264,0.0,43,0
25,12760,-167,231,398,0.0,43,0
0,51558,-3221,4724,7945,2.8,60,0
1,38598,-13928,1934,15862,0.0,60,0
2,27220,-11960,95,12055,0.0,59,-1
3,22241,-5445,194,5639,0.0,59,0
4,21324,-1370,468,1838,0.2,59,0
5,20584,-1054,369,1423,2.6,59,0
6,20134,-678,407,1085,0.4,58,-1
7,19871,-552,572,1124,5.7,58,0
8,19835,-208,423,631,2.5,58,0
9,20505,366,1125,759,1.0,58,0
10,20479,-166,807,973,1.7,58,0
11,20332,-274,407,681,1.8,58,0
12,20280,-169,449,618,0.0,58,0
13,20115,-375,552,927,1.3,58,0
14,20186,-20,487,507,0.0,58,0
15,18618,-1092,120,1212,0.1,58,0
16,19568,483,951,468,1.9,58,0
17,19568,483,951,468,0.0,58,0
18,19742,136,887,751,0.9,58,0
19,19852,33,602,569,0.5,58,0
20,20128,153,708,555,0.2,58,0
21,21744,1398,2118,720,0.0,58,0
22,23856,1481,3231,1750,11.4,58,0
23,23856,1481,3231,1750,5.9,58,0
24,44733,20059,22770,2711,3.6,58,0
25,46068,1178,11326,10148,6.7,58,0
0,6993,-2789,153,2942,0.0,60,0
1,5504,-1701,133,1834,0.0,60,0
2,5910,-69,814,883,5.8,60,0
3,7906,690,1879,1189,7.8,60,0
4,8402,1,1062,1061,3.3,60,0
5,8922,-39,1005,1044,2.0,60,0
6,9742,350,1329,979,2.5,60,0
7,10063,-189,1058,1247,0.0,60,0
8,9599,-635,354,989,3.2,60,0
9,10154,156,935,779,2.0,60,0
10,9957,-354,532,886,1.9,60,0
11,9821,-277,281,558,1.6,60,0
12,9757,-193,290,483,10.8,60,0
13,12226,1945,2629,684,5.9,60,0
14,16453,3930,4896,966,2.3,60,0
15,29389,4647,9715,5068,2.4,60,0
16,27652,2085,6636,4551,2.7,60,0
17,27652,2085,6636,4551,9.7,60,0
18,26069,-1335,4337,5672,0.0,60,0
19,20764,-5228,439,5667,0.0,60,0
20,17737,-3142,383,3525,0.0,60,0
21,15749,-2082,415,2497,6.0,60,0
22,115813,87199,91643,4444,11.7,60,0
23,115813,87199,91643,4444,6.5,60,0
24,106496,1539,21423,19884,0.0,60,0
25,44951,-59386,2590,61976,0.0,60,0
0,20376,-7386,129,7515,0.0,50,0
1,15704,-4983,129,5112,0.0,50,0
2,13517,-2417,76,2493,0.0,50,0
3,12294,-1309,127,1436,0.0,49,-1
4,11337,-987,35,1022,0.0,49,0
5,10720,-676,95,771,0.0,49,0
6,10269,-478,64,542,3.8,49,0
7,14631,3083,3810,727,1.4,49,0
8,14869,453,1586,1133,1.5,49,0
9,16421,999,2226,1227,3.5,49,0
10,16308,-166,1015,1181,4.5,49,0
11,17528,939,1490,551,3.1,49,0
12,21798,3902,4536,634,1.8,49,0
13,24383,2267,3752,1485,4.0,49,0
14,32929,7721,8885,1164,9.1,49,0
15,148530,20811,49806,28995,3.5,49,0
16,133175,-4785,14841,19626,4.9,49,0
17,133175,-4785,14841,19626,3.8,49,0
18,128380,-5883,10953,16836,8.2,49,0
19,133563,3683,12843,9160,1.8,49,0
20,131925,-1966,6180,8146,1.8,49,0
21,221344,87144,94806,7662,3.4,50,1
22,605513,342743,357629,14886,3.3,50,0
23,605513,342743,357629,14886,0.0,50,0
24,540058,-28025,28180,56205,1.1,51,1
25,434386,-100904,13148,114052,1.5,51,0
0,55990,-6566,1093,7659,3.3,55,0
1,49202,-7504,1577,9081,3.5,55,0
2,45251,-4586,1017,5603,6.3,55,0
3,44448,-1973,3059,5032,3.3,54,-1
4,40901,-3487,805,4292,8.3,54,0
5,38822,-2444,891,3335,1.1,54,0
6,37587,-1671,1376,3047,1.5,54,0
7,35554,-2119,943,3062,2.9,53,-1
8,34497,-1200,582,1782,6.4,53,0
9,33532,-1136,1202,2338,4.3,53,0
10,34116,303,1910,1607,5.5,53,0
11,36431,2130,3064,934,2.6,53,0
12,38347,1731,3102,1371,2.0,53,0
13,39981,1291,3869,2578,10.1,53,0
14,44481,4104,6364,2260,1.4,53,0
15,37142,-3735,3131,6866,0.5,53,0
16,39361,-1924,1973,3897,3.4,53,0
17,39361,-1924,1973,3897,3.6,53,0
18,36478,-2989,506,3495,6.7,53,0
19,34158,-2370,184,2554,2.6,53,0
20,32924,-1292,386,1678,2.0,53,0
21,33874,826,2340,1514,4.6,53,0
22,53571,15206,18502,3296,1.7,53,0
23,53571,15206,18502,3296,7.4,53,0
24,42418,-6919,1087,8006,4.9,53,0
25,38425,-3991,775,4766,2.5,53,0
0,5338,-1061,218,1279,0.0,55,0
1,3728,-1643,9651,11294,0.0,55,0
2,3193,-598,19,617,0.5,54,-1
3,3106,-190,58,248,3.3,54,0
4,3051,-92,39,131,1.8,54,0
5,3026,-79,71,150,0.0,54,0
6,2881,-142,14,156,0.0,54,0
7,2856,-74,33,107,1.5,54,0
8,2851,-26,56,82,0.0,54,0
9,2860,-17,48,65,0.0,54,0
10,2846,-37,28,65,0.0,54,0
11,2785,-67,8,75,0.0,54,0
12,2728,-60,2,62,0.0,54,0
13,2665,-63,8,71,0.0,54,0
14,2651,-18,8,26,0.0,54,0
15,2903,111,197,86,1.6,54,0
16,2830,49,135,86,2.4,54,0
17,2830,49,135,86,0.8,54,0
18,2817,-33,69,102,0.4,54,0
19,2767,-57,17,74,0.3,54,0
20,2772,-9,36,45,1.2,54,0
21,2863,56,108,52,9.6,54,0
22,7630,3847,4454,607,7.0,54,0
23,7630,3847,4454,607,0.7,54,0
24,4961,-1876,866,2742,0.0,54,0
25,3653,-1302,25,1327,0.0,54,0
0,139905,-10246,11817,22063,8.2,65,0
1,158345,11334,45880,34546,2.9,65,0
2,138067,-20647,9361,30008,3.5,65,0
3,118759,-22180,7515,29695,3.6,64,-1
4,98206,-20725,1722,22447,5.3,64,0
5,85826,-13733,2116,15849,0.1,63,-1
6,80485,-6310,3377,9687,2.3,63,0
7,73483,-7534,1994,9528,12.2,62,-1
8,71469,-2619,1687,4306,0.0,62,0
9,75311,2243,6849,4606,8.3,62,0
10,70719,-4150,2119,6269,1.4,62,0
11,69851,-1290,1812,3102,2.0,62,0
12,69107,-1011,2186,3197,12.0,62,0
13,84453,14004,17491,3487,9.0,62,0
14,126896,40550,45855,5305,3.6,62,0
15,156016,14355,38349,23994,3.7,62,0
16,151766,-4344,23336,27680,1.5,62,0
17,151766,-4344,23336,27680,1.9,62,0
18,129445,-21828,3554,25382,7.7,62,0
19,122685,-7512,8061,15573,0.5,62,0
20,100891,-21559,1523,23082,0.0,62,0
21,84778,-16258,756,17014,0.0,62,0
22,77635,-7499,3882,11381,0.0,62,0
23,77635,-7499,3882,11381,0.0,62,0
24,70318,-7288,469,7757,0.0,62,0
25,63956,-6266,372,6638,0.2,62,0
0,11308,-439,552,991,0.0,45,0
1,10565,-1256,472,1728,0.0,45,0
2,9176,-1568,85,1653,0.0,45,0
3,7525,-1675,17,1692,0.0,44,-1
4,6741,-826,18,844,1.7,44,0
5,6821,-44,273,317,2.8,44,0
6,7009,74,368,294,2.2,44,0
7,8503,1089,1616,527,0.7,44,0
8,8389,34,587,553,1.5,44,0
9,8711,170,662,492,3.1,44,0
10,8919,169,628,459,2.5,44,0
11,12174,2962,3288,326,2.5,44,0
12,20245,7859,8423,564,1.0,44,0
13,36837,15597,17582,1985,3.1,44,0
14,54138,16832,19449,2617,3.3,44,0
15,112174,11379,29804,18425,2.6,44,0
16,130388,9466,28689,19223,3.1,44,0
17,130388,9466,28689,19223,1.6,44,0
18,126380,-1616,15675,17291,1.2,44,0
19,118153,-8212,6277,14489,1.4,44,0
20,113148,-5192,3123,8315,3.1,44,0
21,131660,18126,24631,6505,5.2,44,0
22,246803,109019,116655,7636,12.1,45,1
23,246803,109019,116655,7636,1.3,45,0
24,297299,52178,67212,15034,4.7,45,0
25,286977,-8894,38344,47238,4.9,45,0
0,48709,3138,11518,8380,5.1,50,0
1,54686,928,14612,13684,4.8,50,0
2,61472,2386,14835,12449,0.2,50,0
3,60991,-3363,10605,13968,0.0,50,0
4,59497,-2675,6254,8929,0.0,50,0
5,55232,-4925,2788,7713,0.0,50,0
6,51473,-4174,1674,5848,0.3,49,-1
7,49818,-2605,2896,5501,0.0,49,0
8,48251,-1803,1316,3119,0.2,49,0
9,48268,-597,2554,3151,0.0,49,0
10,47080,-1314,1838,3152,2.3,49,0
11,47414,-67,1863,1930,0.0,48,-1
12,47053,-532,1568,2100,0.0,48,0
13,44998,-2140,1438,3578,0.0,48,0
14,43438,-1635,217,1852,0.0,48,0
15,45067,-428,2482,2910,2.4,48,0
16,49667,5634,8783,3149,0.3,48,0
17,49667,5634,8783,3149,0.0,48,0
18,46630,-759,3606,4365,0.1,48,0
19,46809,-43,2538,2581,0.4,48,0
20,47043,74,2583,2509,1.5,48,0
21,48489,1079,3890,2811,8.9,48,0
22,58738,8908,13245,4337,0.0,48,0
23,58738,8908,13245,4337,0.0,48,0
24,53550,-4402,2378,6780,1.6,48,0
25,61123,6308,12039,5731,3.5,48,0
0,4930,-260,373,633,2.5,50,0
1,3913,-1105,186,1291,0.0,50,0
2,3161,-805,33,838,0.0,50,0
3,3250,-177,146,323,0.2,50,0
4,3296,-61,129,190,0.0,50,0
5,3289,-114,104,218,0.5,50,0
6,3300,-89,114,203,2.1,50,0
7,3293,-112,131,243,0.0,50,0
8,3121,-172,29,201,0.0,50,0
9,2956,-174,30,204,9.4,50,0
10,4690,1451,1694,243,5.3,50,0
11,4816,184,474,290,2.7,50,0
12,5012,138,468,330,3.2,50,0
13,4795,-264,420,684,0.0,50,0
14,4449,-352,66,418,5.0,50,0
15,10196,1566,3322,1756,1.8,50,0
16,8927,-25,1305,1330,6.4,50,0
17,8927,-25,1305,1330,2.6,50,0
18,7785,-1078,451,1529,2.7,50,0
19,6756,-1051,110,1161,1.1,50,0
20,6350,-464,158,622,0.0,50,0
21,5491,-857,29,886,0.0,50,0
22,4862,-607,46,653,0.7,50,0
23,4862,-607,46,653,0.0,50,0
24,4715,-228,112,340,0.0,50,0
25,4391,-307,26,333,0.0,50,0
0,1047580,-36200,33990,70190,2.3,55,0
1,1020672,-54570,47616,102186,0.2,55,0
2,960710,-68364,11967,80331,0.8,55,0
3,898131,-75519,23080,98599,4.7,55,0
4,857512,-44720,11102,55822,2.0,55,0
5,824104,-38329,4048,42377,3.9,54,-1
6,799072,-30039,7944,37983,3.0,54,0
7,795807,-11409,12667,24076,3.4,54,0
8,747055,-45982,3609,49591,0.0,54,0
9,698008,-50308,4240,54548,3.8,54,0
10,696415,-8699,6494,15193,5.2,54,0
11,700167,1129,9316,8187,4.7,54,0
12,740085,34319,39929,5610,2.7,54,0
13,757329,11938,27788,15850,1.4,54,0
14,793266,29656,42778,13122,1.6,54,0
15,790644,-7413,44481,51894,3.8,54,0
16,828354,-3312,28184,31496,1.5,54,0
17,828354,-3312,28184,31496,4.9,54,0
18,849888,12505,39332,26827,5.7,54,0
19,869008,15601,31469,15868,4.7,54,0
20,863732,-7103,12289,19392,3.4,54,0
21,1011667,139647,151039,11392,0.7,55,1
22,1303297,248307,278941,30634,2.3,55,0
23,1303297,248307,278941,30634,1.3,55,0
24,1272462,194,40600,40406,1.1,56,1
25,1175405,-92578,20753,113331,2.2,56,0
0,306344,-7381,25148,32529,6.1,45,0
1,328562,14866,66644,51778,1.9,45,0
2,314039,-14700,13697,28397,0.9,45,0
3,286721,-30016,15815,45831,1.2,45,0
4,265012,-21597,4335,25932,3.3,45,0
5,252110,-14306,3008,17314,1.1,45,0
6,237990,-14708,3898,18606,5.2,45,0
7,221429,-15850,8510,24360,3.3,45,0
8,221649,-2503,9987,12490,3.3,44,-1
9,227721,4348,15831,11483,1.8,44,0
10,230127,1595,11389,9794,3.3,44,0
11,253122,21643,26872,5229,2.9,44,0
12,348093,92451,96935,4484,4.5,44,0
13,461279,108680,119119,10439,3.6,45,1
14,603053,137595,149582,11987,0.0,45,0
15,218545,-81015,1869,82884,0.0,45,0
16,256442,-101760,1172,102932,0.0,45,0
17,256442,-101760,1172,102932,1.2,45,0
18,222142,-48185,1073,49258,0.0,45,0
19,191133,-31214,246,31460,0.0,45,0
20,172650,-18657,150,18807,0.0,45,0
21,154029,-18682,257,18939,0.0,44,-1
22,134583,-18641,378,19019,0.0,44,0
23,134583,-18641,378,19019,3.2,44,0
24,135573,-261,5921,6182,0.6,44,0
25,137404,1397,9418,8021,1.1,44,0
0,2586,-224,131,355,4.3,50,0
1,3197,254,735,481,5.4,50,0
2,3499,108,524,416,3.1,50,0
3,3375,-295,227,522,1.0,50,0
4,3318,-158,178,336,4.2,50,0
5,3309,-108,164,272,2.4,50,0
6,3386,-39,249,288,1.0,50,0
7,3511,-20,283,303,2.4,50,0
8,3641,76,296,220,0.0,50,0
9,3166,-475,60,535,4.2,50,0
10,3205,-50,111,161,5.6,49,-1
11,3321,89,210,121,4.1,49,0
12,3464,95,213,118,2.7,49,0
13,3824,266,470,204,5.0,49,0
14,4282,407,612,205,2.2,49,0
15,4793,36,957,921,0.7,49,0
16,5206,322,892,570,4.9,49,0
17,5206,322,892,570,1.0,49,0
18,4745,-345,296,641,3.2,49,0
19,4098,-643,15,658,0.0,49,0
20,3741,-370,11,381,0.0,49,0
21,3472,-281,9,290,0.0,49,0
22,3270,-199,39,238,0.0,49,0
23,3270,-199,39,238,0.2,49,0
24,3244,-51,60,111,3.6,49,0
25,3327,41,156,115,1.2,49,0
0,97704,2797,6754,3957,0.0,40,0
1,103720,2434,8941,6507,0.0,40,0
2,107272,1486,5096,3610,0.0,40,0
3,108650,558,9076,8518,0.0,40,0
4,104014,-4337,1221,5558,0.0,40,0
5,104548,-246,2331,2577,0.0,40,0
6,104934,-94,2077,2171,0.0,40,0
7,107538,1840,4523,2683,0.0,40,0
8,111215,3060,4436,1376,0.6,40,0
9,119647,5288,8435,3147,0.0,40,0
10,117795,711,3722,3011,0.0,40,0
11,119011,1102,2593,1491,0.0,40,0
12,119640,684,2354,1670,0.0,40,0
13,122493,2206,3840,1634,0.0,40,0
14,122805,363,2970,2607,0.0,40,0
15,131375,-3281,3814,7095,0.0,40,0
16,111735,-6588,677,7265,0.0,40,0
17,111735,-6588,677,7265,0.0,40,0
18,110031,-2926,1377,4303,0.0,40,0
19,109089,-1072,1057,2129,0.0,40,0
20,108363,-805,806,1611,0.0,40,0
21,106411,-2029,764,2793,0.0,40,0
22,103137,-3146,1538,4684,0.0,40,0
23,103137,-3146,1538,4684,0.0,40,0
24,101166,-2310,594,2904,0.0,40,0
25,95974,-5012,745,5757,0.0,40,0
0,54426,-5200,2269,7469,5.3,60,0
1,54695,-1726,7182,8908,2.8,60,0
2,50828,-4439,2731,7170,5.0,60,0
3,43568,-7657,1140,8797,6.3,59,-1
4,39658,-4340,521,4861,2.3,59,0
5,36800,-3195,493,3688,1.1,59,0
6,34994,-2212,886,3098,4.2,58,-1
7,32890,-2258,549,2807,5.7,58,0
8,31802,-1270,416,1686,2.1,58,0
9,30669,-1270,715,1985,6.0,58,0
10,29719,-1164,463,1627,2.8,57,-1
11,29256,-561,333,894,1.2,57,0
12,28937,-417,448,865,2.6,57,0
13,27227,-1726,278,2004,0.0,57,0
14,26282,-996,95,1091,0.0,57,0
15,23787,-1159,115,1274,0.4,57,0
16,24161,-27,403,430,2.4,57,0
17,24161,-27,403,430,4.7,57,0
18,23945,-305,304,609,10.1,57,0
19,24326,270,697,427,0.7,57,0
20,24451,57,520,463,1.1,57,0
21,27170,2580,3436,856,10.1,57,0
22,46231,14921,17675,2754,6.1,57,0
23,46231,14921,17675,2754,3.8,57,0
24,38369,-4123,2421,6544,2.9,57,0
25,33654,-4662,967,5629,3.7,57,0
0,38002,3810,7180,3370,9.9,40,0
1,385347,286176,332636,46460,2.7,40,0
2,573259,171940,208820,36880,0.0,40,0
3,613974,43395,115269,71874,0.0,40,0
4,588997,-22376,28191,50567,0.0,41,1
5,555626,-34875,9003,43878,0.0,41,0
6,513717,-41313,9664,50977,0.0,40,-1
7,495499,-19936,20296,40232,0.0,40,0
8,477506,-21025,9503,30528,0.0,40,0
9,456706,-22806,11596,34402,0.0,39,-1
10,462214,-568,19817,20385,0.0,39,0
11,468612,4782,19868,15086,0.0,39,0
12,467423,-972,16869,17841,0.0,39,0
13,471985,1345,24674,23329,0.0,39,0
14,457398,-13094,5413,18507,0.0,39,0
15,342046,-48872,2412,51284,0.0,39,0
16,332325,-38475,966,39441,0.0,39,0
17,332325,-38475,966,39441,0.0,39,0
18,337236,-3018,28693,31711,0.0,38,-1
19,346679,7351,25604,18253,0.0,38,0
20,351117,3603,19299,15696,0.0,38,0
21,352026,-295,16796,17091,0.0,38,0
22,349981,-3617,19156,22773,0.0,38,0
23,349981,-3617,19156,22773,0.0,38,0
24,352688,1253,16208,14955,0.0,38,0
25,370631,6543,31138,24595,0.0,38,0
0,0,0,0,0,0.0,45,0
1,727,418,556,138,0.0,45,0
2,986,112,262,150,0.0,45,0
3,1149,14,216,202,0.0,45,0
4,1248,38,170,132,0.0,45,0
5,1346,25,141,116,0.0,45,0
6,1335,-63,76,139,0.0,45,0
7,1383,-24,105,129,0.0,45,0
8,1474,28,114,86,2.1,45,0
9,1606,94,287,193,0.1,45,0
10,1566,-64,125,189,0.0,45,0
11,1573,-15,64,79,0.0,45,0
12,1557,-48,48,96,0.0,45,0
13,1646,36,142,106,0.7,45,0
14,1773,92,177,85,0.4,45,0
15,3526,302,680,378,0.0,45,0
16,2327,-69,213,282,0.0,45,0
17,2327,-69,213,282,0.0,45,0
18,2090,-219,55,274,0.0,45,0
19,1942,-162,18,180,0.0,45,0
20,1873,-86,34,120,0.4,45,0
21,1858,-47,54,101,0.0,45,0
22,1853,-29,123,152,0.0,45,0
23,1853,-29,123,152,0.0,45,0
24,1807,-58,44,102,0.0,45,0
25,1798,-42,61,103,0.0,45,0
0,0,0,0,0,0.0,40,0
1,1956,638,885,247,0.0,40,0
2,3096,226,590,364,0.0,40,0
3,3890,-13,415,428,0.0,40,0
4,4625,106,434,328,0.0,40,0
5,5132,49,429,380,0.0,40,0
6,5192,-242,204,446,0.0,40,0
7,5599,-94,245,339,0.0,40,0
8,5729,-72,176,248,0.0,40,0
9,5871,-67,266,333,0.0,40,0
10,5980,-120,186,306,0.0,40,0
11,6143,-10,191,201,0.0,40,0
12,6228,-24,168,192,0.0,40,0
13,6642,79,408,329,0.0,40,0
14,6717,-26,178,204,0.0,40,0
15,9298,231,734,503,0.0,40,0
16,7624,48,380,332,0.0,40,0
17,7624,48,380,332,0.0,40,0
18,7456,-125,281,406,0.0,40,0
19,7464,-77,191,268,0.0,40,0
20,7602,49,275,226,0.0,40,0
21,7601,-147,209,356,0.0,40,0
22,7704,-56,317,373,0.0,40,0
23,7704,-56,317,373,0.0,40,0
24,7727,-109,200,309,0.0,40,0
25,7815,-87,238,325,0.0,40,0
0,0,0,0,0,0.0,40,0
1,2488,1944,2114,170,0.0,40,0
2,4210,1361,1620,259,0.0,40,0
3,4443,-20,782,802,0.0,40,0
4,5782,935,1486,551,0.0,40,0
5,6620,699,999,300,0.0,40,0
6,7558,577,1163,586,0.0,40,0
7,7417,-25,630,655,0.0,40,0
8,7695,166,444,278,0.0,40,0
9,7866,123,370,247,0.0,40,0
10,8550,422,706,284,0.0,40,0
11,8772,197,475,278,0.0,40,0
12,27664,1116,1870,754,0.0,40,0
13,11202,332,1253,921,0.0,40,0
14,11202,332,1253,921,0.0,40,0
15,10403,-221,505,726,0.0,40,0
16,10410,-50,277,327,0.0,40,0
17,10445,0,271,271,0.0,40,0
18,10210,-280,230,510,0.0,40,0
19,9968,-293,539,832,0.0,40,0
20,9968,-293,539,832,0.0,40,0
21,9709,-357,209,566,0.0,40,0
22,9167,-592,246,838,0.0,40,0
0,0,0,0,0,0.0,45,0
1,801,445,574,129,0.0,45,0
2,1990,555,1002,447,0.0,45,0
3,2890,624,1176,552,0.0,45,0
4,5215,1529,2676,1147,0.0,45,0
5,5118,-191,1372,1563,0.0,45,0
6,5934,359,1153,794,0.0,45,0
7,5776,-207,591,798,0.0,45,0
8,6364,109,988,879,0.0,45,0
9,6504,29,517,488,0.0,45,0
10,11318,917,2245,1328,0.0,45,0
11,9650,678,1864,1186,0.0,45,0
12,9650,678,1864,1186,0.0,45,0
13,9113,-52,1394,1446,0.0,45,0
14,9740,474,1341,867,0.0,45,0
15,9987,91,1006,915,0.0,45,0
16,9856,-313,647,960,0.0,45,0
17,9814,-294,845,1139,0.0,45,0
18,9814,-294,845,1139,0.0,45,0
19,9817,-163,593,756,0.0,45,0
20,10040,-22,794,816,0.0,45,0
0,0,0,0,0,0.0,45,0
1,1030,578,715,137,0.0,45,0
2,2524,707,1218,511,0.0,45,0
3,3460,617,1128,511,0.0,45,0
4,5128,1048,2092,1044,0.0,45,0
5,5510,23,1378,1355,0.0,45,0
6,5999,128,839,711,0.0,45,0
7,6202,-53,614,667,0.0,45,0
8,7082,283,1160,877,0.0,45,0
9,7276,-6,504,510,0.0,45,0
10,9443,457,1447,990,0.0,45,0
11,9002,156,887,731,0.0,45,0
12,9002,156,887,731,0.0,45,0
13,8768,-231,815,1046,0.0,45,0
14,8959,11,579,568,0.0,45,0
15,9046,-84,518,602,0.0,45,0
16,9136,-166,486,652,0.0,45,0
17,9487,18,865,847,0.0,45,0
18,9487,18,865,847,0.0,45,0
19,9668,-47,644,691,0.0,45,0
20,10021,43,796,753,0.0,45,0
0,0,0,0,0,0.0,45,0
1,30,19,23,4,0.0,45,0
2,290,75,133,58,0.0,45,0
3,232,11,58,47,0.0,45,0
4,232,11,58,47,0.0,45,0
5,279,23,98,75,0.0,45,0
6,230,-61,22,83,0.0,45,0
7,303,61,105,44,0.0,44,-1
8,328,-11,62,73,0.0,44,0
9,444,64,192,128,0.0,44,0
10,444,64,192,128,0.0,44,0
11,509,53,148,95,0.0,44,0
12,545,-33,122,155,0.0,44,0
0,0,0,0,0,0.0,45,0
1,95,67,80,13,0.0,45,0
2,1840,323,555,232,0.0,45,0
3,1191,106,355,249,0.0,45,0
4,1191,106,355,249,0.0,45,0
5,1172,-5,254,259,0.0,45,0
6,1296,66,215,149,0.1,45,0
7,1749,356,582,226,0.0,45,0
8,1865,25,370,345,0.0,45,0
9,2480,424,892,468,0.0,45,0
10,2480,424,892,468,0.0,45,0
11,2387,-135,365,500,0.0,45,0
12,3228,600,1104,504,0.0,45,0
0,0,0,0,0,0.0,40,0
1,179,104,116,12,0.0,40,0
2,482,128,267,139,0.0,40,0
3,482,128,267,139,0.0,40,0
4,565,-8,135,143,0.0,40,0
5,766,38,189,151,0.0,40,0
0,20402,0,0,0,0.0,50,0
1,21606,-3419,654,4073,0.0,50,0
2,21775,-1955,1763,3718,0.4,49,-1
3,20955,-1607,753,2360,0.0,49,0
4,20127,-1660,780,2440,0.0,49,0
5,19249,-1185,262,1447,0.0,48,-1
6,18627,-967,233,1200,0.0,48,0
7,17945,-808,145,953,0.0,48,0
8,17297,-874,71,945,0.0,48,0
9,16997,-466,48,514,0.0,47,-1
10,16611,-506,81,587,0.0,47,0
11,16435,-331,55,386,0.0,47,0
12,16257,-249,35,284,0.0,47,0
13,16103,-220,39,259,0.0,47,0
14,16000,-253,51,304,0.0,47,0
15,15949,-129,27,156,0.0,47,0
16,15849,-177,46,223,0.0,47,0
17,15789,-103,66,169,0.0,47,0
18,15789,-103,66,169,0.0,47,0
19,15763,-159,61,220,0.0,47,0
20,15747,-75,40,115,0.0,47,0
21,15731,-90,33,123,0.0,47,0
22,15753,-77,82,159,0.0,47,0
23,15721,-140,64,204,0.0,46,-1
24,15719,-101,73,174,0.0,46,0
25,15690,-116,65,181,0.0,46,0
0,469354,0,0,0,0.3,60,0
1,406897,-93651,7314,100965,0.0,60,0
2,326684,-91835,7743,99578,5.4,59,-1
3,308792,-27062,5523,32585,4.2,59,0
4,317349,-3047,17751,20798,2.7,59,0
5,298787,-18206,6710,24916,1.8,59,0
6,313895,9884,19880,9996,0.0,59,0
7,287936,-25661,4556,30217,0.0,59,0
8,260439,-29198,4266,33464,0.0,58,-1
9,240464,-21374,1486,22860,0.0,58,0
10,225521,-15806,1512,17318,0.0,57,-1
11,213737,-13006,684,13690,0.0,57,0
12,207330,-6955,470,7425,0.0,57,0
13,201171,-6470,391,6861,3.4,57,0
14,202931,917,5633,4716,0.0,56,-1
15,198707,-4412,801,5213,4.3,56,0
16,195955,-3053,776,3829,5.4,56,0
17,191979,-721,1387,2108,4.6,56,0
18,191979,-721,1387,2108,0.0,56,0
19,190476,-1812,844,2656,5.1,56,0
20,192926,1882,3295,1413,8.8,56,0
21,227964,33034,35750,2716,2.8,56,0
22,337518,104625,109212,4587,3.7,57,1
23,360186,19956,38716,18760,5.5,57,0
24,387418,24863,38699,13836,2.2,57,0
25,388474,-1220,36871,38091,5.0,57,0
0,75648,0,0,0,0.0,70,0
1,72643,-16605,3843,20448,0.0,70,0
2,59225,-18198,2116,20314,0.8,69,-1
3,54627,-8166,1619,9785,0.0,68,-1
4,51351,-6317,1735,8052,0.0,68,0
5,49748,-3103,1245,4348,0.0,67,-1
6,47729,-2979,631,3610,0.2,67,0
7,46650,-1665,528,2193,0.1,67,0
8,46209,-1329,709,2038,0.2,67,0
9,46193,-542,550,1092,1.9,67,0
10,68951,17917,19928,2011,13.9,67,0
11,101677,31527,38645,7118,3.4,67,0
12,101912,173,10957,10784,7.9,67,0
13,133016,28267,34615,6348,0.0,67,0
14,115930,-17744,13083,30827,0.0,67,0
15,107207,-10352,8093,18445,7.7,67,0
16,116745,7494,20961,13467,0.0,67,0
17,129720,15670,27361,11691,9.6,67,0
18,129720,15670,27361,11691,0.0,67,0
19,108105,-19659,6854,26513,7.7,67,0
20,118128,8405,17393,8988,0.0,67,0
21,105140,-13120,3588,16708,0.0,67,0
22,95668,-10461,2523,12984,0.7,67,0
23,91171,-5407,4246,9653,7.4,67,0
24,114668,21329,26553,5224,0.0,67,0
25,118179,1882,19229,17347,1.3,67,0
0,205442,0,0,0,2.4,60,0
1,213795,-20423,6368,26791,2.3,60,0
2,224535,-5707,19032,24739,3.8,60,0
3,192705,-33710,3050,36760,0.0,59,-1
4,167525,-28625,2583,31208,0.0,59,0
5,152520,-16722,1781,18503,0.0,58,-1
6,142062,-11913,1580,13493,0.0,58,0
7,132947,-9795,1147,10942,0.0,58,0
8,126806,-7053,1529,8582,0.0,57,-1
9,123109,-4197,668,4865,0.0,57,0
10,119889,-3678,701,4379,0.0,57,0
11,117243,-3157,430,3587,0.0,57,0
12,115702,-1805,269,2074,0.0,57,0
13,114107,-1807,268,2075,0.0,57,0
14,112772,-1800,705,2505,0.0,56,-1
15,111818,-1105,177,1282,0.0,56,0
16,110866,-1140,193,1333,0.0,56,0
17,109082,-445,171,616,0.0,56,0
18,109082,-445,171,616,0.0,56,0
19,108288,-1031,197,1228,0.0,56,0
20,107994,-445,263,708,11.1,56,0
21,144532,34993,36584,1591,5.2,56,0
22,261969,114305,117358,3053,1.3,57,1
23,251885,-9325,21661,30986,13.3,57,0
24,276227,21587,33810,12223,4.9,57,0
25,261456,-14566,22491,37057,0.0,57,0
0,104796,0,0,0,10.1,50,0
1,342805,137736,177637,39901,3.5,50,0
2,453345,88001,173083,85082,0.0,51,1
3,412226,-44619,48051,92670,15.1,51,0
4,781585,303609,374657,71048,2.2,52,1
5,923955,140287,189777,49490,0.6,52,0
6,1036955,102550,152049,49499,0.0,53,1
7,915848,-114879,46750,161629,0.3,53,0
8,759988,-155701,31366,187067,0.0,52,-1
9,648772,-122039,12829,134868,0.0,51,-1
10,526772,-120188,9585,129773,0.0,50,-1
11,462321,-75395,6985,82380,0.0,49,-1
12,419808,-43885,5003,48888,0.0,49,0
13,379968,-41237,3137,44374,1.2,48,-1
14,369040,-12670,13411,26081,4.9,48,0
15,355766,-13729,4742,18471,1.6,48,0
16,342927,-13627,6048,19675,0.0,48,0
17,315251,-6928,9860,16788,3.2,47,-1
18,315251,-6928,9860,16788,0.0,47,0
19,302304,-13509,4695,18204,4.3,47,0
20,290136,-12480,2794,15274,7.1,47,0
21,284510,-6118,3335,9453,9.0,47,0
22,295397,9693,16706,7013,8.2,47,0
23,333571,34489,45836,11347,1.8,47,0
24,344193,9885,25767,15882,0.0,47,0
25,358107,10432,37663,27231,0.0,47,0
0,7235,0,0,0,0.0,55,0
1,15328,1793,3838,2045,1.1,55,0
2,24340,3183,7357,4174,0.9,55,0
3,26520,-278,4658,4936,0.0,55,0
4,24648,-3630,2319,5949,0.0,55,0
5,22553,-2864,914,3778,0.0,54,-1
6,20884,-2134,480,2614,0.0,54,0
7,19233,-1852,346,2198,5.5,53,-1
8,18733,-797,797,1594,7.3,53,0
9,19423,407,1073,666,3.6,53,0
10,20618,848,1836,988,1.6,53,0
11,20286,-418,908,1326,3.2,53,0
12,20543,65,808,743,2.3,53,0
13,20139,-502,448,950,0.3,53,0
14,19966,-453,684,1137,0.3,53,0
15,19799,-282,341,623,0.0,53,0
16,19321,-583,245,828,1.4,53,0
17,19009,8,396,388,3.9,53,0
18,19009,8,396,388,2.7,53,0
19,18819,-310,287,597,6.4,53,0
20,18861,-86,277,363,6.3,53,0
21,19159,172,521,349,3.3,53,0
22,19523,128,636,508,4.1,53,0
23,19991,142,863,721,6.9,53,0
24,20979,620,1242,622,2.7,53,0
25,21671,283,1279,996,4.7,53,0
0,133067,0,0,0,0.0,50,0
1,115488,-34536,4611,39147,0.0,49,-1
2,90763,-30077,4791,34868,0.0,48,-1
3,74266,-19227,2018,21245,0.0,47,-1
4,65611,-10912,2357,13269,0.0,47,0
5,61891,-4912,1943,6855,0.0,46,-1
6,59731,-2958,1902,4860,0.0,46,0
7,56779,-3307,1354,4661,0.0,46,0
8,54269,-3067,1082,4149,2.7,45,-1
9,55681,750,1986,1236,0.0,45,0
10,54588,-1330,1076,2406,0.0,45,0
11,53395,-1515,927,2442,0.0,45,0
12,52748,-910,611,1521,0.0,45,0
13,52087,-884,616,1500,0.0,45,0
14,51657,-875,1017,1892,0.0,45,0
15,51120,-700,418,1118,4.6,45,0
16,51226,-187,780,967,0.0,45,0
17,50770,-165,585,750,6.3,45,0
18,50770,-165,585,750,1.8,45,0
19,53370,2161,4010,1849,3.5,45,0
20,79365,25179,27268,2089,1.5,45,0
21,103952,24185,26689,2504,2.5,45,0
22,232883,126273,129096,2823,4.0,46,1
23,245226,12416,30200,17784,1.1,46,0
24,287139,39589,52983,13394,4.9,46,0
25,284917,-1611,33341,34952,2.3,46,0
0,53224,0,0,0,6.9,50,0
1,89752,7097,15614,8517,3.6,50,0
2,148022,33603,52299,18696,0.0,50,0
3,124337,-23094,6291,29385,7.0,50,0
4,312917,139084,165810,26726,4.8,50,0
5,290727,-9060,28838,37898,4.1,50,0
6,544259,226234,238536,12302,6.1,51,1
7,1126522,548818,561350,12532,1.8,53,1
8,1375103,230257,287310,57053,3.0,54,1
9,1458690,98408,144943,46535,1.6,55,1
10,1614934,132635,162105,29470,6.8,56,1
11,1779480,151524,171846,20322,7.3,57,1
12,1844843,57728,81968,24240,3.3,57,0
13,1902184,48749,87171,38422,1.8,58,1
14,2108037,186183,235506,49323,3.6,59,1
15,2091158,-17379,54516,71895,0.0,59,0
16,1942991,-152502,32040,184542,2.5,59,0
17,1682489,-35229,59653,94882,0.0,58,-1
18,1682489,-35229,59653,94882,0.0,58,0
19,1339984,-343608,10907,354515,0.0,57,-1
20,1121805,-221932,5864,227796,0.0,56,-1
21,972455,-151734,2815,154549,0.0,55,-1
22,836494,-137160,3066,140226,0.0,55,0
23,749712,-86496,5325,91821,0.0,54,-1
24,718609,-36099,4395,40494,4.2,54,0
25,693755,-25600,5235,30835,0.0,54,0
0,11017,0,0,0,0.0,50,0
1,12610,-1812,430,2242,0.0,50,0
2,12263,-1592,608,2200,0.0,49,-1
3,11795,-1168,457,1625,0.0,49,0
4,11355,-990,403,1393,0.0,49,0
5,11104,-575,250,825,0.0,48,-1
6,10886,-493,227,720,0.0,48,0
7,10495,-511,148,659,0.0,48,0
8,10318,-424,159,583,0.7,48,0
9,10369,-123,158,281,0.0,48,0
10,10273,-213,132,345,0.0,47,-1
11,10225,-207,130,337,0.0,47,0
12,10183,-137,83,220,0.0,47,0
13,10118,-164,96,260,2.0,47,0
14,14680,3902,4569,667,0.0,47,0
15,12561,-1912,280,2192,0.0,47,0
16,11567,-1107,140,1247,0.0,47,0
17,11235,-196,205,401,0.0,47,0
18,11235,-196,205,401,0.0,47,0
19,11073,-289,139,428,0.0,47,0
20,10999,-140,81,221,0.0,47,0
21,10947,-124,75,199,0.0,47,0
22,10953,-91,129,220,0.0,47,0
23,10996,-131,132,263,0.0,47,0
24,11048,-51,143,194,0.0,47,0
25,11052,-112,133,245,0.0,47,0
0,132136,0,0,0,1.0,50,0
1,136627,-14874,9656,24530,1.8,50,0
2,133908,-12338,23297,35635,0.0,50,0
3,98359,-34954,1574,36528,0.0,49,-1
4,87191,-15536,6812,22348,2.2,48,-1
5,76694,-10665,1516,12181,0.0,48,0
6,62711,-14371,86,14457,0.0,48,0
7,56830,-6204,90,6294,0.0,48,0
8,53896,-3376,219,3595,0.0,48,0
9,52176,-1997,100,2097,0.0,48,0
10,50089,-2248,185,2433,0.0,48,0
11,49035,-1398,149,1547,0.0,47,-1
12,48240,-898,83,981,0.0,47,0
13,47335,-1012,73,1085,0.0,47,0
14,46480,-1017,104,1121,0.0,47,0
15,46003,-599,65,664,0.0,47,0
16,45484,-623,87,710,0.0,47,0
17,44554,-336,175,511,0.0,47,0
18,44554,-336,175,511,0.0,47,0
19,44289,-442,160,602,0.0,47,0
20,44199,-209,147,356,0.0,47,0
21,44002,-270,68,338,0.0,47,0
22,43953,-189,278,467,0.0,47,0
23,43805,-326,233,559,2.8,47,0
24,47161,2913,3596,683,0.0,47,0
25,45717,-1533,458,1991,0.0,47,0
0,234920,0,0,0,2.4,50,0
1,289355,-10834,25961,36795,2.5,50,0
2,298835,-15492,29932,45424,2.5,50,0
3,299713,-12401,24755,37156,1.8,50,0
4,249646,-53812,7334,61146,1.3,49,-1
5,244737,-12997,9706,22703,0.8,49,0
6,242959,-6491,9224,15715,4.5,49,0
7,239228,-6154,9175,15329,4.9,49,0
8,243919,216,15489,15273,4.0,49,0
9,252782,5623,15167,9544,5.5,49,0
10,256725,1334,14705,13371,1.6,49,0
11,257476,-1432,11113,12545,3.2,49,0
12,255867,-2995,7074,10069,3.9,49,0
13,251247,-6102,5351,11453,2.7,49,0
14,254168,-326,11328,11654,3.2,49,0
15,250109,-4925,3663,8588,6.7,49,0
16,244470,-7022,3820,10842,1.4,49,0
17,205870,-11801,197,11998,0.0,49,0
18,205870,-11801,197,11998,0.0,49,0
19,197568,-9421,728,10149,0.0,49,0
20,194084,-4002,629,4631,0.0,49,0
21,192253,-2375,755,3130,1.1,49,0
22,189987,-2882,695,3577,0.4,49,0
23,187946,-2809,1083,3892,1.5,49,0
24,186831,-1854,828,2682,2.9,49,0
25,187155,-722,1748,2470,5.7,49,0
0,139604,0,0,0,0.0,80,0
1,96757,-47694,3531,51225,0.0,80,0
2,76002,-24444,6263,30707,0.0,79,-1
3,65758,-11936,2610,14546,0.0,79,0
4,89625,17927,32892,14965,1.8,79,0
5,90948,990,13324,12334,0.1,79,0
6,114819,20552,32109,11557,7.9,79,0
7,624213,478430,489814,11384,15.2,80,1
8,1430384,745737,764461,18724,5.0,82,1
9,1392583,21373,128009,106636,4.9,83,1
10,1316716,-86643,80008,166651,2.9,83,0
11,472004,-839622,4162,843784,0.0,82,-1
12,301359,-186056,429,186485,0.0,81,-1
13,246454,-57826,1417,59243,0.0,81,0
14,205470,-40987,3094,44081,0.0,81,0
15,190693,-15973,542,16515,0.0,81,0
16,182681,-8561,3121,11682,3.9,81,0
17,238522,46734,55646,8912,6.5,81,0
18,238522,46734,55646,8912,2.2,81,0
19,218475,-12383,13963,26346,10.8,81,0
20,218289,-1406,13727,15133,0.0,81,0
21,195731,-22847,3027,25874,0.0,81,0
22,185952,-10755,5156,15911,0.0,80,-1
23,169887,-16693,2034,18727,0.0,80,0
24,161654,-9292,959,10251,1.4,79,-1
25,156364,-5796,1075,6871,10.8,79,0
0,17362,0,0,0,2.1,50,0
1,24305,-285,2136,2421,1.5,50,0
2,22483,-3888,1870,5758,2.0,50,0
3,22240,-1519,1492,3011,0.0,49,-1
4,20756,-2219,768,2987,3.9,49,0
5,20647,-697,823,1520,0.0,49,0
6,20026,-998,499,1497,0.0,49,0
7,18913,-1277,357,1634,0.0,48,-1
8,18121,-1085,312,1397,0.0,48,0
9,17627,-650,211,861,0.0,48,0
10,17121,-614,170,784,0.0,48,0
11,16781,-489,134,623,0.0,47,-1
12,16609,-278,107,385,0.0,47,0
13,16447,-265,80,345,0.0,47,0
14,16324,-313,208,521,0.0,47,0
15,16243,-172,106,278,1.1,47,0
16,16325,-56,208,264,0.0,47,0
17,16053,-110,139,249,0.0,47,0
18,16053,-110,139,249,0.0,47,0
19,16047,-128,183,311,0.0,47,0
20,16071,-57,109,166,0.0,47,0
21,16048,-93,107,200,1.1,47,0
22,16857,639,835,196,2.2,47,0
23,17044,25,687,662,1.8,47,0
24,18091,887,1400,513,0.0,47,0
25,18295,15,915,900,4.7,47,0
0,2838333,0,0,0,9.6,95,0
1,2546205,-471452,80020,551472,3.5,95,0
2,2485820,-174552,254577,429129,7.8,95,0
3,1810085,-679035,49742,728777,3.5,94,-1
4,1418242,-433994,63666,497660,16.0,93,-1
5,1533733,82072,175637,93565,2.5,93,0
6,1519754,-24129,83534,107663,11.4,93,0
7,1746317,192177,239502,47325,7.4,94,1
8,1888748,112487,184655,72168,6.4,95,1
9,1739656,-114654,38416,153070,4.2,95,0
10,1788332,18464,110136,91672,19.0,95,0
11,1653233,-126213,36688,162901,3.2,95,0
12,1521257,-138035,18781,156816,6.7,94,-1
13,1364119,-160253,17697,177950,9.7,94,0
14,1203125,-161915,15553,177468,3.6,93,-1
15,1081341,-126484,5796,132280,0.4,93,0
16,982688,-101407,3896,105303,3.9,92,-1
17,968981,46126,74115,27989,1.9,92,0
18,968981,46126,74115,27989,0.1,92,0
19,919760,-38493,38068,76561,0.0,92,0
20,963096,40169,85114,44945,8.8,92,0
21,946321,-17211,33288,50499,10.4,92,0
22,996201,45784,73561,27777,6.7,92,0
23,933911,-59229,21876,81105,12.1,92,0
24,1002752,61206,90584,29378,1.9,92,0
25,937537,-62681,28529,91210,2.2,92,0
0,278989,0,0,0,0.0,75,0
1,227720,-70539,4713,75252,2.2,74,-1
2,178418,-57625,5515,63140,7.9,73,-1
3,185520,-3107,16716,19823,7.0,73,0
4,194958,2211,23517,21306,0.0,73,0
5,168944,-25627,3458,29085,0.3,73,0
6,155594,-15443,2268,17711,7.5,72,-1
7,159919,2395,9662,7267,16.1,72,0
8,174462,11147,19793,8646,13.4,72,0
9,197930,21711,29494,7783,2.2,72,0
10,258430,49429,63602,14173,0.3,72,0
11,210464,-39128,7644,46772,0.7,72,0
12,196034,-16436,5288,21724,0.0,72,0
13,178920,-17533,2618,20151,11.1,72,0
14,216939,32598,42682,10084,8.3,72,0
15,266057,47671,58282,10611,0.0,72,0
16,240125,-24560,15052,39612,0.0,72,0
17,331844,94866,120358,25492,2.4,72,0
18,331844,94866,120358,25492,4.7,72,0
19,309012,-13665,41693,55358,0.2,72,0
20,298479,-11925,29192,41117,0.1,72,0
21,268427,-30677,13288,43965,0.0,72,0
22,247876,-22233,13266,35499,0.0,72,0
23,229281,-19914,17347,37261,0.3,72,0
24,203293,-26559,5925,32484,0.4,72,0
25,194982,-9298,6297,15595,0.0,71,-1
0,650190,0,0,0,0.0,85,0
1,367635,-322911,28655,351566,0.0,84,-1
2,207071,-170911,7561,178472,0.0,83,-1
3,182756,-32278,14895,47173,0.6,83,0
4,299458,97839,133339,35500,5.3,83,0
5,282728,-12039,24436,36475,5.4,83,0
6,312128,24487,47391,22904,0.0,83,0
7,183223,-125327,3254,128581,0.0,83,0
8,133316,-52590,454,53044,0.0,82,-1
9,127362,-7687,628,8315,0.5,82,0
10,129992,1416,4682,3266,12.8,82,0
11,203907,71543,75810,4267,0.0,82,0
12,182473,-19697,8087,27784,4.3,82,0
13,190955,6903,16809,9906,7.7,82,0
14,194706,2370,15890,13520,9.3,82,0
15,197497,1910,13869,11959,6.2,82,0
16,187321,-10791,8257,19048,3.8,82,0
17,181804,5004,15075,10071,4.4,82,0
18,181804,5004,15075,10071,2.6,82,0
19,172264,-7848,8183,16031,0.6,82,0
20,165475,-7270,4631,11901,7.9,82,0
21,163462,-2622,5544,8166,0.4,82,0
22,162630,-1697,8031,9728,0.0,82,0
23,150177,-12863,2404,15267,0.0,82,0
24,142250,-8847,980,9827,0.0,82,0
25,136200,-6303,628,6931,0.2,82,0
0,518922,0,0,0,5.1,70,0
1,456584,-87707,15540,103247,1.6,70,0
2,406197,-65777,32862,98639,18.4,69,-1
3,561764,119900,163939,44039,0.0,69,0
4,462770,-96494,33793,130287,7.5,69,0
5,406053,-62513,13121,75634,1.2,69,0
6,359236,-51008,7462,58470,10.4,68,-1
7,360234,-2678,21030,23708,5.5,68,0
8,335534,-25442,11810,37252,9.0,68,0
9,343508,4921,20202,15281,3.7,68,0
10,343553,-2482,18310,20792,18.7,68,0
11,410068,62718,76887,14169,2.4,68,0
12,466081,55524,76749,21225,4.4,68,0
13,458124,-8429,31653,40082,11.3,69,1
14,462609,1214,36528,35314,8.1,69,0
15,458078,-6511,24916,31427,8.5,69,0
16,421575,-37475,14219,51694,5.8,69,0
17,404660,15882,41728,25846,21.2,68,-1
18,404660,15882,41728,25846,8.7,68,0
19,418914,16070,45288,29218,2.0,68,0
20,381304,-37592,8307,45899,6.5,68,0
21,367671,-15379,9024,24403,10.3,68,0
22,406690,35140,50128,14988,8.3,68,0
23,448748,36364,59041,22677,9.1,68,0
24,439700,-10150,21267,31417,10.7,68,0
25,517535,68852,102220,33368,7.4,68,0
0,28187,0,0,0,0.2,60,0
1,24640,-7163,1444,8607,0.0,59,-1
2,18974,-6871,982,7853,10.0,58,-1
3,29562,7007,11179,4172,5.3,58,0
4,29958,-840,5507,6347,0.0,58,0
5,25332,-4911,908,5819,0.0,58,0
6,23142,-2735,834,3569,1.8,58,0
7,21628,-1777,702,2479,0.0,58,0
8,20005,-1960,506,2466,1.4,57,-1
9,19768,-497,578,1075,0.0,57,0
10,19172,-766,468,1234,0.0,57,0
11,17747,-1483,172,1655,0.0,57,0
12,16793,-969,22,991,0.0,57,0
13,16235,-591,21,612,0.0,57,0
14,16041,-312,186,498,8.1,57,0
15,22830,6160,6573,413,5.1,57,0
16,20152,-2389,796,3185,9.1,57,0
17,26344,4313,6077,1764,0.8,57,0
18,26344,4313,6077,1764,2.6,57,0
19,24261,-1505,2018,3523,8.6,57,0
20,28391,3685,5719,2034,11.2,57,0
21,57749,28185,30168,1983,4.5,57,0
22,78092,19546,25001,5455,3.3,57,0
23,67075,-10768,6980,17748,6.0,57,0
24,61058,-7278,5247,12525,0.6,57,0
25,50259,-10881,3726,14607,4.2,57,0
0,304155,0,0,0,11.8,50,0
1,593870,163043,219376,56333,3.2,50,0
2,1135471,426692,522263,95571,13.1,51,1
3,1152060,24920,129142,104222,0.0,51,0
4,957377,-195624,52523,248147,0.2,51,0
5,785928,-178983,11973,190956,4.3,50,-1
6,833926,30239,66708,36469,3.0,50,0
7,901837,62788,88908,26120,5.4,50,0
8,936916,29343,82283,52940,3.5,50,0
9,975673,41159,68964,27805,6.5,51,1
10,1223340,208720,227125,18405,6.5,52,1
11,1340242,130398,155129,24731,5.4,53,1
12,1400542,56416,87003,30587,4.7,53,0
13,1424039,19976,66186,46210,0.0,53,0
14,988256,-422668,9788,432456,4.0,52,-1
15,993066,-12379,40390,52769,0.0,52,0
16,794896,-197082,8234,205316,0.0,52,0
17,584609,-20524,38997,59521,0.0,51,-1
18,584609,-20524,38997,59521,9.3,51,0
19,548096,-34776,15788,50564,0.0,51,0
20,512195,-36519,6379,42898,3.2,51,0
21,481212,-31551,2650,34201,8.4,51,0
22,520289,36418,49964,13546,6.1,50,-1
23,533287,11563,30934,19371,2.3,50,0
24,520771,-13690,13558,27248,3.6,50,0
25,499508,-21362,12205,33567,4.5,50,0
0,10890,0,0,0,0.0,45,0
1,10716,-1169,738,1907,0.0,45,0
2,9702,-1301,583,1884,0.0,45,0
3,9001,-860,292,1152,0.0,45,0
4,8034,-1009,184,1193,0.0,45,0
5,7575,-548,198,746,0.0,45,0
6,7406,-241,299,540,0.0,44,-1
7,7121,-294,198,492,0.0,44,0
8,7209,-80,500,580,0.0,44,0
9,7495,147,507,360,0.0,44,0
10,7461,-72,413,485,0.0,44,0
11,7991,381,761,380,0.8,44,0
12,8530,518,787,269,0.0,44,0
13,8630,68,382,314,0.0,44,0
14,9146,327,797,470,0.0,44,0
15,9085,-88,279,367,0.0,44,0
16,8850,-278,301,579,0.7,44,0
17,9585,309,857,548,0.0,44,0
18,9585,309,857,548,0.0,44,0
19,9152,-382,450,832,0.0,44,0
20,8611,-571,160,731,0.0,44,0
21,8314,-349,103,452,0.0,44,0
22,8044,-309,99,408,0.0,44,0
23,7882,-231,172,403,0.0,44,0
24,7821,-143,151,294,0.0,44,0
25,7901,-37,243,280,0.0,44,0
0,72270,0,0,0,0.0,55,0
1,65868,-13057,2777,15834,0.0,55,0
2,108096,27294,45001,17707,0.0,55,0
3,122194,7687,23008,15321,14.8,55,0
4,791150,578624,652656,74032,12.1,56,1
5,1032032,254369,299463,45094,5.1,57,1
6,1575600,511343,529253,17910,2.9,58,1
7,1887786,295038,324298,29260,15.8,59,1
8,2313447,390012,452842,62830,2.9,60,1
9,2456691,164087,206567,42480,5.5,61,1
10,2737574,234568,257173,22605,5.0,62,1
11,2725434,-38,76263,76301,1.7,62,0
12,2707806,-27030,43885,70915,8.8,62,0
13,2762601,38047,74976,36929,0.0,62,0
14,1861324,-878355,23369,901724,2.3,61,-1
15,1870392,-23326,62814,86140,5.1,61,0
16,1911863,33457,101915,68458,2.5,61,0
17,1827756,44842,119283,74441,3.0,61,0
18,1827756,44842,119283,74441,2.0,61,0
19,1789556,-24401,87351,111752,1.0,61,0
20,1871774,74504,127395,52891,0.0,61,0
21,1703470,-165286,22565,187851,0.0,61,0
22,1463360,-245077,38291,283368,1.8,60,-1
23,1338612,-123870,29857,153727,0.0,59,-1
24,1226505,-119472,15020,134492,0.0,59,0
25,1039245,-184564,7434,191998,3.6,58,-1
0,179186,0,0,0,0.0,55,0
1,140573,-49718,4131,53849,0.0,55,0
2,154113,-5244,26200,31444,1.4,55,0
3,153372,-9276,11181,20457,4.4,55,0
4,159307,-5784,20012,25796,0.0,55,0
5,145137,-16061,5500,21561,3.4,55,0
6,188042,32516,38138,5622,4.9,55,0
7,220996,27304,35517,8213,8.9,55,0
8,250182,20720,53437,32717,0.0,55,0
9,240914,-10104,10449,20553,1.6,55,0
10,275219,24856,31794,6938,3.3,55,0
11,276108,-544,13069,13613,2.1,55,0
12,275248,-3359,7505,10864,3.2,55,0
13,272200,-5296,7277,12573,7.9,55,0
14,370693,86210,96403,10193,2.8,56,1
15,370524,714,22521,21807,0.0,56,0
16,347049,-26186,10924,37110,1.2,56,0
17,321969,-38,13031,13069,5.9,56,0
18,321969,-38,13031,13069,5.5,56,0
19,318184,-6081,12189,18270,3.0,56,0
20,355938,33177,40784,7607,3.2,56,0
21,390462,31910,41997,10087,0.9,56,0
22,344502,-47513,26240,73753,0.0,56,0
23,276642,-66579,1000,67579,0.0,56,0
24,253296,-26312,770,27082,0.0,56,0
25,229040,-24219,520,24739,0.0,56,0
0,755977,0,0,0,2.3,85,0
1,638996,-184734,47344,232078,0.3,85,0
2,601436,-78935,132850,211785,9.4,84,-1
3,633799,18647,110346,91699,6.5,84,0
4,646767,-11232,102135,113367,6.8,84,0
5,626460,-21025,53692,74717,1.9,84,0
6,603864,-29416,45665,75081,4.8,84,0
7,398791,-201179,20547,221726,0.0,84,0
8,279426,-122484,2059,124543,0.0,83,-1
9,267152,-18517,3449,21966,0.0,83,0
10,256073,-12574,4528,17102,2.9,83,0
11,253406,-4063,10600,14663,3.4,83,0
12,250952,-3352,7251,10603,2.1,83,0
13,243167,-8281,4179,12460,0.3,83,0
14,230728,-13133,2687,15820,0.8,82,-1
15,225529,-6016,1597,7613,1.0,82,0
16,218820,-7225,880,8105,4.7,82,0
17,213891,469,3374,2905,0.0,82,0
18,213891,469,3374,2905,1.3,82,0
19,209441,-4712,2293,7005,5.5,82,0
20,214902,4668,7868,3200,1.8,82,0
21,211333,-3757,1800,5557,0.0,82,0
22,205315,-6304,1163,7467,0.0,82,0
23,198089,-7198,148,7346,0.0,82,0
24,195340,-3043,370,3413,0.0,82,0
25,194537,-1347,939,2286,0.0,82,0
0,16303,12224,18188,5964,0.0,50,0
1,48377,22224,27763,5539,0.5,50,0
2,92649,34292,78019,43727,0.0,50,0
3,84818,-8437,10609,19046,1.9,50,0
4,236936,126963,132126,5163,0.3,50,0
5,459299,195527,205864,10337,1.7,51,1
6,498511,30636,65101,34465,1.4,51,0
7,522718,22592,46062,23470,0.9,51,0
8,682911,128656,140381,11725,0.7,52,1
9,703839,24910,49925,25015,2.5,52,0
10,706775,-2023,21435,23458,1.2,52,0
11,693784,-17479,18691,36170,0.4,52,0
12,692634,-7863,23014,30877,3.4,52,0
13,658619,-36547,8180,44727,1.4,52,0
14,589439,-71667,6194,77861,2.4,52,0
15,571270,30143,65221,35078,1.2,51,-1
16,571270,30143,65221,35078,3.4,51,0
17,527451,-32535,13637,46172,0.4,51,0
18,550385,18819,34237,15418,0.2,51,0
19,542010,-8741,11457,20198,1.3,51,0
20,643368,93584,102709,9125,2.3,51,0
21,629859,-13883,27056,40939,0.0,51,0
22,585036,-49175,9669,58844,0.6,51,0
23,528454,-55696,7948,63644,2.9,51,0
0,0,0,0,0,0.0,40,0
1,4589,3098,3500,402,0.0,40,0
2,11247,4114,5252,1138,0.0,40,0
3,16487,2951,3814,863,0.0,40,0
4,19364,2045,3595,1550,0.0,40,0
5,21891,3159,4374,1215,0.0,40,0
6,24786,2210,3158,948,0.0,40,0
7,26518,2117,3091,974,0.0,40,0
8,35500,5752,7020,1268,0.0,40,0
9,37542,2805,4060,1255,0.0,40,0
10,41796,3985,6396,2411,0.0,40,0
11,62665,4718,7951,3233,0.0,40,0
12,62665,4718,7951,3233,0.0,40,0
13,59574,2980,6535,3555,0.0,40,0
14,61671,1679,3670,1991,0.0,40,0
15,63426,1291,3059,1768,0.0,40,0
16,62027,-1325,1477,2802,0.0,40,0
17,59838,-2241,723,2964,0.0,40,0
18,58674,-1403,351,1754,0.0,40,0
19,56192,-2417,440,2857,0.0,40,0
0,0,0,0,0,0.0,45,0
1,55,33,38,5,0.0,45,0
2,90,16,32,16,0.0,45,0
3,179,37,69,32,0.0,45,0
4,201,10,42,32,0.0,45,0
5,222,-7,45,52,0.0,45,0
6,344,12,60,48,0.0,45,0
7,344,12,60,48,0.0,45,0
8,348,-18,34,52,0.0,45,0
9,351,-17,15,32,0.0,45,0
10,375,1,31,30,0.0,45,0
11,389,1,23,22,0.0,45,0
12,427,7,40,33,0.0,45,0
13,439,-6,40,46,0.0,45,0
14,464,3,41,38,0.0,45,0
0,121096,0,0,0,0.0,60,0
1,119307,-23133,13155,36288,0.2,60,0
2,87628,-36028,4255,40283,0.2,59,-1
3,57098,-31787,456,32243,0.0,58,-1
4,51776,-8034,1974,10008,0.8,58,0
5,59327,5365,9921,4556,10.6,58,0
6,61388,891,6569,5678,4.2,58,0
7,63701,1560,7175,5615,0.0,58,0
8,58227,-6195,3317,9512,5.0,58,0
9,59051,-435,3355,3790,1.5,58,0
10,55270,-3802,1900,5702,0.0,58,0
11,51611,-4011,857,4868,0.0,58,0
12,50018,-1881,497,2378,0.0,57,-1
13,48539,-1637,442,2079,0.0,57,0
14,47251,-1577,541,2118,3.6,57,0
15,46746,-699,319,1018,0.0,57,0
16,46447,-491,665,1156,0.0,57,0
17,47704,-89,1836,1925,0.0,57,0
18,46304,-450,625,1075,0.0,57,0
19,46191,-491,848,1339,5.0,57,0
20,47848,1375,2166,791,4.7,57,0
21,49002,937,2056,1119,1.6,57,0
22,49623,276,1823,1547,1.7,57,0
23,49658,-226,1792,2018,0.5,57,0
24,49875,-72,1507,1579,0.0,57,0
25,49453,-719,1223,1942,0.0,57,0
0,5946,0,0,0,0.0,45,0
1,5794,-870,211,1081,0.0,45,0
2,5103,-899,195,1094,0.0,45,0
3,4720,-495,106,601,0.0,45,0
4,5291,377,896,519,2.6,45,0
5,6523,925,2162,1237,0.0,45,0
6,5905,-596,230,826,0.0,45,0
7,5699,-253,204,457,0.0,45,0
8,7491,1158,1635,477,0.0,45,0
9,8183,491,1063,572,1.3,45,0
10,9346,711,1361,650,4.8,45,0
11,9884,444,1254,810,4.3,45,0
12,11139,964,1417,453,0.0,45,0
13,11186,-11,907,918,1.3,45,0
14,10443,-975,1238,2213,0.0,45,0
15,9074,-1382,26,1408,0.0,45,0
16,8063,-1056,35,1091,0.0,45,0
17,7256,-714,68,782,0.0,45,0
18,7448,-14,243,257,2.4,45,0
19,8089,407,793,386,3.2,45,0
20,8387,215,541,326,0.0,45,0
21,8419,-72,332,404,5.4,45,0
22,10742,1925,2289,364,2.3,45,0
23,12586,1549,2673,1124,0.0,45,0
24,12043,-685,731,1416,3.5,45,0
25,12854,502,1431,929,3.5,45,0
0,49581,0,0,0,0.0,45,0
1,51906,-4599,2012,6611,0.0,45,0
2,49845,-4682,1723,6405,0.0,45,0
3,47866,-3119,815,3934,0.0,45,0
4,44352,-4177,1124,5301,0.0,44,-1
5,40375,-4080,196,4276,0.0,44,0
6,37290,-3300,82,3382,0.0,44,0
7,34922,-2396,51,2447,0.0,44,0
8,32619,-2287,60,2347,0.0,44,0
9,31425,-1313,61,1374,0.0,44,0
10,29806,-1587,61,1648,0.0,44,0
11,29016,-912,70,982,0.0,43,-1
12,28395,-635,57,692,0.0,43,0
13,27749,-669,51,720,0.0,43,0
14,26982,-750,87,837,0.0,43,0
15,26497,-532,42,574,0.0,43,0
16,25874,-622,51,673,0.0,43,0
17,24694,-882,69,951,0.0,43,0
18,24510,-451,25,476,0.0,43,0
19,24135,-453,84,537,0.0,43,0
20,23940,-212,117,329,0.0,43,0
21,23653,-296,58,354,0.0,43,0
22,23317,-352,56,408,0.0,43,0
23,22988,-318,133,451,0.0,43,0
24,22775,-245,50,295,0.0,43,0
25,22539,-237,70,307,0.0,43,0
0,1486,0,0,0,0.0,45,0
1,3758,303,657,354,1.8,45,0
2,15556,6181,8132,1951,1.4,45,0
3,18389,1030,3497,2467,1.0,45,0
4,22351,2035,5422,3387,0.0,45,0
5,22186,-576,2330,2906,0.3,45,0
6,21718,-1005,1419,2424,0.0,45,0
7,20582,-1401,1011,2412,0.0,45,0
8,19963,-1089,961,2050,0.0,45,0
9,19591,-636,629,1265,0.0,45,0
10,18811,-968,441,1409,0.0,45,0
11,18211,-795,410,1205,0.0,44,-1
12,17766,-563,289,852,0.0,44,0
13,16371,-1386,22,1408,0.0,44,0
14,14658,-1679,38,1717,0.0,44,0
15,14182,-539,14,553,0.0,44,0
16,14289,-21,339,360,0.0,44,0
17,14128,-244,431,675,0.0,44,0
18,13685,-457,13,470,0.0,44,0
19,13064,-647,19,666,0.0,44,0
20,12822,-260,19,279,0.0,44,0
21,12592,-236,11,247,0.0,44,0
22,12363,-234,15,249,0.0,44,0
23,12109,-263,25,288,0.0,44,0
24,11953,-160,21,181,0.0,44,0
25,11816,-145,23,168,0.0,44,0
0,87269,0,0,0,4.1,50,0
1,203846,30722,49711,18989,1.4,50,0
2,297108,54379,113617,59238,2.2,50,0
3,307883,4764,34200,29436,1.7,50,0
4,358251,37974,73187,35213,1.4,50,0
5,347005,-7906,17708,25614,1.3,50,0
6,318627,-28525,3669,32194,2.4,50,0
7,301877,-17521,4890,22411,0.9,50,0
8,296717,-8182,8858,17040,2.9,50,0
9,291786,-6047,6489,12536,2.5,50,0
10,280217,-12052,5508,17560,2.3,50,0
11,258625,-21424,906,22330,3.5,50,0
12,253608,-6586,3476,10062,1.0,49,-1
13,242245,-12002,2235,14237,0.4,49,0
14,229859,-12510,2187,14697,4.6,49,0
15,221910,-8730,1322,10052,3.6,49,0
16,260903,34609,42385,7776,1.4,48,-1
17,255787,-4918,18425,23343,2.6,48,0
18,235391,-14820,8767,23587,1.8,48,0
19,250397,6321,21023,14702,2.7,48,0
20,251293,356,9509,9153,2.7,48,0
21,259402,6701,11927,5226,3.3,48,0
22,264743,4627,12369,7742,3.8,48,0
23,262410,-2200,10621,12821,0.7,48,0
24,256022,-7653,4531,12184,3.7,48,0
25,249955,-5975,5195,11170,2.7,48,0
0,538,0,0,0,0.0,45,0
1,547,-77,34,111,0.0,45,0
2,494,-83,26,109,0.0,45,0
3,457,-53,19,72,0.0,45,0
4,569,72,154,82,0.0,45,0
5,1050,256,383,127,0.0,45,0
6,1399,146,293,147,0.0,45,0
7,1525,6,207,201,0.0,45,0
8,1286,-263,91,354,0.0,45,0
9,1475,71,163,92,0.0,45,0
10,1555,-13,133,146,0.0,45,0
11,1580,-61,107,168,0.0,45,0
12,1651,5,98,93,0.0,45,0
13,1700,-12,93,105,0.3,45,0
14,1858,26,194,168,0.0,45,0
15,1925,16,120,104,1.2,45,0
16,3194,1067,1360,293,2.0,45,0
17,7788,1246,2361,1115,2.5,45,0
18,4490,-100,584,684,1.6,45,0
19,4332,-343,874,1217,0.0,45,0
20,3541,-788,34,822,0.0,45,0
21,3054,-507,11,518,0.0,45,0
22,2748,-311,9,320,0.0,45,0
23,2524,-220,23,243,0.0,45,0
24,2423,-125,20,145,0.0,44,-1
25,2296,-122,27,149,0.0,44,0
0,12911,0,0,0,2.8,55,0
1,14328,-1288,1024,2312,3.2,55,0
2,13693,-1568,858,2426,3.3,55,0
3,13049,-1139,614,1753,3.7,55,0
4,12150,-1182,551,1733,0.6,54,-1
5,11436,-877,242,1119,0.0,54,0
6,10522,-1021,132,1153,0.0,54,0
7,9700,-900,113,1013,1.2,53,-1
8,9313,-487,160,647,4.7,53,0
9,9218,-179,231,410,5.1,53,0
10,9061,-218,224,442,4.0,53,0
11,9027,-84,242,326,3.3,53,0
12,8971,-84,172,256,1.4,53,0
13,8834,-178,136,314,1.1,53,0
14,8787,-122,227,349,2.8,52,-1
15,8747,-78,170,248,0.2,52,0
16,8673,-115,168,283,6.8,52,0
17,11229,782,1426,644,3.9,52,0
18,9381,-168,319,487,2.4,52,0
19,9623,88,628,540,4.7,52,0
20,9414,-234,192,426,0.0,52,0
21,8990,-453,74,527,0.0,52,0
22,8372,-619,12,631,0.0,52,0
23,7873,-505,21,526,0.0,52,0
24,7552,-341,14,355,0.0,52,0
25,7269,-291,17,308,0.0,52,0
0,144113,0,0,0,0.9,45,0
1,168330,2657,25422,22765,2.1,45,0
2,196339,17622,51329,33707,4.0,45,0
3,198262,-96,21542,21638,1.0,45,0
4,161832,-34262,5889,40151,0.0,45,0
5,131542,-31819,471,32290,0.0,45,0
6,117155,-16277,203,16480,0.0,45,0
7,106407,-10900,162,11062,0.5,45,0
8,100880,-5823,1584,7407,0.0,45,0
9,98765,-2982,1418,4400,0.0,45,0
10,92424,-6097,886,6983,0.0,45,0
11,90428,-2782,1409,4191,0.0,44,-1
12,88689,-1951,1095,3046,0.0,44,0
13,86420,-2418,951,3369,0.0,44,0
14,85032,-1727,1977,3704,0.0,44,0
15,83006,-2163,739,2902,0.0,44,0
16,79989,-3168,703,3871,0.0,44,0
17,94689,-286,5739,6025,0.0,43,-1
18,86450,2907,8166,5259,1.7,43,0
19,85164,841,7177,6336,0.0,43,0
20,79967,-5126,1226,6352,0.6,43,0
21,74920,-5068,184,5252,0.0,43,0
22,70619,-4328,57,4385,0.0,43,0
23,66667,-3865,337,4202,0.0,43,0
24,64331,-2554,61,2615,0.0,43,0
25,63596,-877,718,1595,0.1,43,0
0,15812,0,0,0,0.0,55,0
1,12391,-4142,320,4462,0.0,55,0
2,11543,-1933,10469,12402,0.4,55,0
3,13776,424,1877,1453,0.0,55,0
4,14662,-387,1591,1978,0.6,55,0
5,15662,302,1776,1474,0.0,55,0
6,15270,-785,838,1623,0.2,55,0
7,15174,-369,721,1090,0.3,55,0
8,15278,-338,799,1137,4.5,55,0
9,15422,-103,542,645,3.2,55,0
10,15458,-182,596,778,22.1,55,0
11,25379,8401,10225,1824,9.3,55,0
12,30092,4280,6539,2259,8.8,55,0
13,24783,-4977,1939,6916,0.0,55,0
14,32606,6379,9529,3150,2.9,55,0
15,35859,3012,6194,3182,1.4,55,0
16,57924,20548,27208,6660,0.9,55,0
17,81607,3890,19667,15777,7.6,55,0
18,56067,-4099,10689,14788,0.0,55,0
19,53623,-4869,7001,11870,3.7,55,0
20,60476,6096,11464,5368,0.0,55,0
21,54446,-6087,3590,9677,0.5,55,0
22,47614,-7199,1715,8914,2.3,55,0
23,43284,-4565,2849,7414,9.4,55,0
24,41474,-2351,2260,4611,5.1,55,0
25,53098,10213,14708,4495,1.4,55,0
0,14565,0,0,0,3.0,50,0
1,17116,-784,1626,2410,3.7,50,0
2,17336,-915,1869,2784,8.9,50,0
3,51908,27932,35314,7382,1.9,50,0
4,50924,-1105,9277,10382,1.5,50,0
5,52322,52,7051,6999,2.1,50,0
6,50274,-2703,3711,6414,1.5,50,0
7,48167,-2464,3463,5927,1.7,50,0
8,46064,-2473,3287,5760,5.9,50,0
9,46318,-460,3057,3517,5.2,50,0
10,43079,-3190,1753,4943,1.8,50,0
11,40496,-2762,1041,3803,1.3,50,0
12,39093,-1609,969,2578,1.8,50,0
13,37232,-1995,696,2691,0.4,50,0
14,35870,-1573,1306,2879,1.8,50,0
15,34746,-1240,472,1712,1.8,50,0
16,34310,-625,1465,2090,3.2,50,0
17,38251,248,3604,3356,1.2,50,0
18,32976,-1568,971,2539,0.0,50,0
19,31539,-1916,635,2551,1.2,50,0
20,29848,-1756,213,1969,1.3,49,-1
21,29415,-563,551,1114,0.0,49,0
22,28285,-1155,156,1311,0.0,49,0
23,27180,-1137,347,1484,2.9,49,0
24,26543,-748,148,896,2.7,49,0
25,26755,60,804,744,1.0,48,-1
0,105207,0,0,0,1.4,45,0
1,125159,-641,13560,14201,3.9,45,0
2,132085,812,19555,18743,0.3,45,0
3,122312,-10768,3889,14657,2.1,45,0
4,119361,-5085,10169,15254,1.0,45,0
5,120457,-191,8465,8656,0.0,45,0
6,100625,-19424,798,20222,0.0,45,0
7,80238,-20330,46,20376,0.0,44,-1
8,68346,-12240,324,12564,0.0,44,0
9,66149,-3002,557,3559,0.0,44,0
10,61524,-4526,413,4939,0.0,44,0
11,58341,-3576,231,3807,0.0,44,0
12,56406,-2071,352,2423,7.1,43,-1
13,58751,1882,3188,1306,0.0,43,0
14,57808,-1139,2058,3197,1.8,43,0
15,57396,-559,1631,2190,0.0,43,0
16,55940,-1599,1337,2936,2.5,43,0
17,73610,5374,9719,4345,2.3,43,0
18,61719,391,4320,3929,2.7,43,0
19,62193,-214,3627,3841,1.4,43,0
20,61824,-522,2204,2726,0.2,43,0
21,60805,-1138,1108,2246,0.0,43,0
22,56988,-3813,299,4112,0.0,43,0
23,52822,-3999,232,4231,0.0,43,0
24,52086,-1120,269,1389,2.6,43,0
25,51573,-612,931,1543,1.0,43,0
0,79848,0,0,0,0.0,45,0
1,66325,-16545,880,17425,0.0,45,0
2,54105,-13665,1424,15089,0.0,44,-1
3,47279,-7603,672,8275,0.0,44,0
4,42060,-5717,1031,6748,0.0,43,-1
5,39307,-3159,1115,4274,0.0,43,0
6,37208,-2352,718,3070,0.0,43,0
7,35072,-2264,507,2771,0.0,43,0
8,33556,-1786,1089,2875,0.0,42,-1
9,32947,-766,865,1631,0.0,42,0
10,30940,-2005,653,2658,0.0,42,0
11,27710,-3260,61,3321,0.0,42,0
12,26039,-1725,34,1759,0.0,42,0
13,24600,-1490,39,1529,0.0,42,0
14,22816,-1775,91,1866,0.0,41,-1
15,22056,-814,70,884,0.0,41,0
16,21148,-914,37,951,0.0,41,0
17,19655,-1106,77,1183,0.0,41,0
18,19423,-577,33,610,0.0,41,0
19,18848,-650,70,720,0.0,41,0
20,18448,-421,58,479,0.0,41,0
21,18332,-147,159,306,0.0,41,0
22,18563,141,401,260,0.0,41,0
23,18914,241,718,477,0.0,41,0
24,18912,-17,415,432,0.0,41,0
25,18936,-66,425,491,0.0,41,0
0,85742,0,0,0,0.0,45,0
1,83421,-8049,9889,17938,0.0,45,0
2,72987,-12310,7875,20185,0.0,45,0
3,65476,-9023,3941,12964,0.0,45,0
4,57650,-8449,2327,10776,0.0,45,0
5,54023,-4378,2189,6567,0.0,45,0
6,51943,-2467,2514,4981,0.0,45,0
7,47467,-4472,370,4842,0.0,45,0
8,44142,-3272,481,3753,0.0,45,0
9,43191,-1269,570,1839,0.0,45,0
10,41931,-1330,430,1760,0.0,45,0
11,41739,-354,1281,1635,0.0,44,-1
12,44479,1573,3038,1465,0.0,44,0
13,44153,513,2551,2038,0.0,44,0
14,44457,68,3173,3105,0.0,44,0
15,43690,-610,1328,1938,0.0,44,0
16,43200,-524,1834,2358,0.0,44,0
17,56576,1612,5976,4364,0.0,44,0
18,57568,5163,9185,4022,0.0,44,0
19,50999,663,6796,6133,0.0,44,0
20,53520,2300,5505,3205,0.0,44,0
21,53605,195,4047,3852,0.0,44,0
22,50932,-2626,1554,4180,0.0,44,0
23,50331,-774,3173,3947,0.0,44,0
24,48109,-2214,990,3204,0.0,44,0
25,47805,-643,2639,3282,0.0,44,0
0,16534,0,0,0,6.4,60,0
1,51702,11126,18748,7622,10.1,60,0
2,127637,53033,85897,32864,7.1,60,0
3,267037,115403,148642,33239,3.7,61,1
4,268785,-420,56780,57200,2.2,61,0
5,249458,-20703,20309,41012,5.9,61,0
6,217206,-34170,8937,43107,6.4,60,-1
7,190466,-27795,7397,35192,3.0,60,0
8,171750,-20187,8374,28561,10.5,59,-1
9,171715,-3158,12379,15537,3.1,59,0
10,156793,-14456,5876,20332,0.0,59,0
11,137330,-20036,1783,21819,0.0,58,-1
12,128764,-9366,1700,11066,6.6,58,0
13,122641,-6577,1553,8130,0.0,57,-1
14,113811,-9156,1704,10860,2.1,57,0
15,109707,-4540,590,5130,6.4,57,0
16,112240,1846,5702,3856,6.8,57,0
17,112831,-2787,4201,6988,4.5,57,0
18,104842,-4325,1015,5340,1.2,56,-1
19,103078,-2969,1675,4644,1.1,56,0
20,99588,-3569,318,3887,0.9,56,0
21,97214,-2503,282,2785,1.0,56,0
22,94719,-2575,297,2872,3.7,56,0
23,92493,-2313,676,2989,5.1,55,-1
24,90822,-1925,205,2130,4.7,55,0
25,90588,-471,1023,1494,4.0,55,0
0,57448,0,0,0,3.4,60,0
1,52037,-10435,1828,12263,0.8,60,0
2,41247,-12339,1443,13782,0.0,59,-1
3,33894,-8374,978,9352,1.1,58,-1
4,29715,-4885,779,5664,0.0,58,0
5,27329,-2749,472,3221,2.0,57,-1
6,26090,-1574,451,2025,0.8,57,0
7,21021,-5020,55,5075,0.0,57,0
8,18172,-2891,23,2914,0.0,56,-1
9,17295,-984,49,1033,0.0,56,0
10,17166,-282,272,554,2.8,56,0
11,17189,-97,312,409,3.8,56,0
12,17301,19,316,297,3.7,56,0
13,17233,-136,197,333,4.7,56,0
14,17303,-105,339,444,3.6,56,0
15,17249,-127,180,307,1.1,56,0
16,17450,98,444,346,4.3,56,0
17,17500,-334,372,706,0.9,56,0
18,17023,-209,139,348,1.1,56,0
19,17044,-121,211,332,1.4,56,0
20,16857,-234,57,291,3.8,56,0
21,16803,-109,82,191,3.0,56,0
22,16696,-170,85,255,0.5,56,0
23,16661,-120,242,362,2.7,56,0
24,16551,-199,84,283,1.8,56,0
25,16645,0,208,208,4.4,56,0
0,5818,0,0,0,0.0,55,0
1,5358,-1168,141,1309,0.0,55,0
2,4637,-973,184,1157,0.0,55,0
3,4241,-558,109,667,0.0,54,-1
4,9467,4534,6566,2032,0.0,54,0
5,15288,5198,7556,2358,1.2,54,0
6,17971,2250,4669,2419,3.6,54,0
7,28198,8993,11753,2760,6.6,54,0
8,60376,27099,32755,5656,4.0,54,0
9,77179,15740,21022,5282,6.2,54,0
10,77375,615,10205,9590,9.7,54,0
11,63647,-10883,3212,14095,2.9,54,0
12,61475,-3109,2973,6082,2.7,54,0
13,54118,-7580,2146,9726,1.3,54,0
14,49356,-5277,3824,9101,2.6,54,0
15,45404,-4323,2085,6408,0.0,54,0
16,54969,8058,14073,6015,0.0,54,0
17,39300,-10394,2444,12838,0.0,54,0
18,33453,-10398,403,10801,0.0,54,0
19,30896,-4249,935,5184,0.0,54,0
20,28219,-2781,464,3245,5.1,54,0
21,33030,4347,5521,1174,3.0,54,0
22,33276,28,2364,2336,0.2,54,0
23,35361,1669,5007,3338,2.5,54,0
24,34350,-1311,2107,3418,0.0,54,0
25,31886,-2553,1301,3854,2.6,54,0
0,403544,0,0,0,2.9,60,0
1,366405,-58033,22747,80780,4.9,60,0
2,320684,-57984,23450,81434,1.0,59,-1
3,268502,-58242,12219,70461,1.5,59,0
4,232254,-41370,13397,54767,0.0,58,-1
5,163256,-68494,1364,69858,0.0,58,0
6,136449,-29754,1196,30950,0.4,57,-1
7,130358,-7495,3149,10644,8.6,57,0
8,139231,6063,14771,8708,3.1,57,0
9,142855,2391,9671,7280,2.0,57,0
10,146277,1513,12445,10932,0.6,57,0
11,131674,-13008,2766,15774,0.0,57,0
12,125619,-6782,1646,8428,0.1,57,0
13,120488,-5498,1539,7037,3.3,57,0
14,118087,-3140,3467,6607,0.0,57,0
15,115254,-3070,1400,4470,0.1,56,-1
16,115517,-259,4054,4313,1.5,56,0
17,124330,1602,8640,7038,1.8,56,0
18,115066,-2286,2737,5023,3.4,56,0
19,114816,-1240,3817,5057,6.0,56,0
20,115183,83,2942,2859,5.3,56,0
21,126261,10314,13036,2722,2.9,56,0
22,124942,-1413,4795,6208,6.4,56,0
23,127259,1698,9180,7482,8.3,56,0
24,126344,-1362,5319,6681,4.7,56,0
25,140330,12476,18950,6474,1.7,56,0
0,461359,0,0,0,5.4,70,0
1,603201,18583,93188,74605,17.1,70,0
2,1210529,466643,598146,131503,5.1,71,1
3,1490194,244879,378872,133993,4.6,72,1
4,1371672,-139108,191682,330790,5.8,72,0
5,1541444,133920,240498,106578,22.3,72,0
6,2009284,441776,482570,40794,5.2,73,1
7,2153649,134174,252864,118690,9.8,74,1
8,2263264,83431,208184,124753,0.0,74,0
9,1429165,-796361,29524,825885,0.0,73,-1
10,1120326,-335104,38608,373712,16.0,73,0
11,1397764,246103,287699,41596,4.3,74,1
12,1682629,279088,316730,37642,3.6,75,1
13,1693584,12825,115009,102184,2.7,75,0
14,1606382,-90788,86747,177535,4.7,75,0
15,1499144,-113813,39863,153676,6.3,75,0
16,1718216,200889,259167,58278,8.3,74,-1
17,1566937,-105143,83550,188693,4.0,74,0
18,1313208,-264972,16420,281392,0.0,73,-1
19,1162758,-201519,34685,236204,7.9,72,-1
20,1173907,4308,55101,50793,4.0,72,0
21,1222621,45028,92289,47261,0.7,72,0
22,967976,-252091,7045,259136,0.0,72,0
23,762570,-204382,609,204991,0.0,71,-1
24,706032,-62666,260,62926,0.0,71,0
25,671010,-35146,447,35593,0.0,71,0
0,5393,0,0,0,0.1,55,0
1,5833,-657,331,988,9.4,55,0
2,12769,4620,6820,2200,0.0,55,0
3,8654,-3802,446,4248,0.0,55,0
4,6385,-2446,68,2514,1.9,55,0
5,6625,-112,518,630,3.9,55,0
6,6659,-122,416,538,3.1,55,0
7,6650,-154,380,534,1.7,55,0
8,6471,-345,321,666,0.5,54,-1
9,6357,-165,279,444,4.4,54,0
10,6146,-270,255,525,6.6,54,0
11,5965,-210,152,362,13.2,54,0
12,7515,1372,1599,227,0.0,54,0
13,7242,-240,438,678,4.9,54,0
14,7506,118,765,647,2.2,54,0
15,7331,-210,276,486,3.6,54,0
16,7799,378,949,571,5.2,54,0
17,6179,-1238,337,1575,0.0,54,0
18,5769,-778,15,793,0.0,54,0
19,5275,-558,50,608,0.0,54,0
20,5042,-233,47,280,0.0,54,0
21,4905,-147,39,186,0.0,54,0
22,4763,-139,21,160,0.0,53,-1
23,4627,-146,22,168,0.0,53,0
24,4533,-95,22,117,0.0,53,0
25,4459,-72,13,85,0.0,53,0
0,11161,0,0,0,0.0,45,0
1,10593,-1651,460,2111,0.0,45,0
2,8455,-2167,134,2301,0.1,45,0
3,29526,13795,19836,6041,0.1,44,-1
4,28843,1016,6933,5917,2.0,44,0
5,42013,10553,15784,5231,7.4,44,0
6,68799,23823,29712,5889,3.8,44,0
7,99909,27934,37641,9707,1.1,44,0
8,137402,34371,51052,16681,6.3,44,0
9,153857,17365,27940,10575,0.6,44,0
10,147304,-4914,12712,17626,0.1,44,0
11,144871,-2567,9175,11742,0.1,44,0
12,142742,-2260,6763,9023,0.0,44,0
13,136709,-6496,4728,11224,0.0,44,0
14,137121,-347,9917,10264,1.8,44,0
15,132509,-4660,3411,8071,1.2,44,0
16,129013,-3965,7086,11051,0.0,44,0
17,114247,-10363,7104,17467,0.0,44,0
18,103942,-13179,2012,15191,0.2,44,0
19,95593,-11512,1513,13025,0.6,44,0
20,82416,-13229,423,13652,0.6,44,0
21,75344,-7237,126,7363,6.6,44,0
22,73426,-2195,1694,3889,2.7,44,0
23,69277,-3921,2052,5973,2.5,44,0
24,66361,-3405,1356,4761,1.4,44,0
25,66758,-68,4220,4288,1.5,44,0
0,113206,0,0,0,0.0,40,0
1,104495,-10093,5366,15459,0.0,40,0
2,92070,-13068,7835,20903,0.0,40,0
3,86691,-5933,3025,8958,0.0,40,0
4,76797,-10042,6764,16806,0.0,40,0
5,70721,-6420,1238,7658,0.0,40,0
6,67118,-3738,524,4262,0.0,40,0
7,63341,-3743,290,4033,0.0,40,0
8,58245,-5122,1131,6253,0.0,39,-1
9,57220,-1589,1068,2657,0.0,39,0
10,55674,-1653,1119,2772,0.0,39,0
11,55231,-328,1381,1709,0.0,39,0
12,54991,-431,956,1387,0.0,39,0
13,55491,560,2316,1756,0.0,39,0
14,53609,-1995,1381,3376,0.0,39,0
15,49546,-4026,562,4588,0.0,39,0
16,46025,-3533,231,3764,0.0,39,0
17,38643,-2887,463,3350,0.0,39,0
18,40493,-2773,197,2970,0.0,39,0
19,39043,-1774,373,2147,0.0,39,0
20,37933,-1134,329,1463,0.0,39,0
21,38695,482,1865,1383,0.0,38,-1
22,41963,2822,5331,2509,0.0,38,0
23,44274,1394,4834,3440,0.0,38,0
24,43664,52,3324,3272,0.0,38,0
25,49231,2891,6922,4031,0.0,38,0
0,783246,0,0,0,1.8,40,0
1,1222530,266503,313081,46578,1.3,40,0
2,1680837,390665,451120,60455,3.1,41,1
3,1813731,120420,175712,55292,1.0,41,0
4,1922192,89411,198576,109165,1.0,41,0
5,1943442,16161,87186,71025,4.0,42,1
6,1891746,-52387,33850,86237,0.0,42,0
7,1706256,-177716,10961,188677,0.0,42,0
8,1496091,-210604,20899,231503,0.0,41,-1
9,1472886,-42304,25174,67478,0.0,41,0
10,1371762,-93873,20960,114833,0.0,41,0
11,1315023,-71931,21756,93687,0.0,40,-1
12,1239325,-75627,10300,85927,0.0,40,0
13,1196474,-48312,16826,65138,0.0,40,0
14,1169158,-34239,42889,77128,0.0,39,-1
15,1131427,-38233,26543,64776,2.1,39,0
16,1148523,14283,62149,47866,2.8,39,0
17,1658542,101983,162937,60954,4.8,39,0
18,1394508,115421,168821,53400,1.3,39,0
19,1430029,57027,128001,70974,2.3,39,0
20,1436784,4857,60454,55597,0.0,39,0
21,1398013,-40193,26924,67117,0.0,39,0
22,1310062,-89073,17706,106779,1.7,39,0
23,1252083,-55514,32949,88463,0.0,39,0
24,1209225,-49103,16186,65289,2.2,39,0
25,1190139,-24104,53401,77505,0.0,39,0
0,18959,0,0,0,2.4,45,0
1,83312,23357,34970,11613,0.0,45,0
2,72733,-10225,8490,18715,0.0,45,0
3,56408,-16800,118,16918,0.0,45,0
4,53569,-4267,1103,5370,0.0,45,0
5,50647,-3249,568,3817,1.9,45,0
6,50171,-1027,1208,2235,5.1,44,-1
7,49943,-454,2175,2629,7.1,44,0
8,70973,17765,21978,4213,2.9,44,0
9,78758,7574,11319,3745,1.4,44,0
10,79246,-36,6322,6358,0.0,44,0
11,68336,-8743,863,9606,0.0,44,0
12,62389,-6201,414,6615,3.4,44,0
13,59327,-3311,728,4039,0.0,44,0
14,55165,-4205,1019,5224,1.6,44,0
15,53588,-1808,832,2640,0.0,44,0
16,53983,-21,3929,3950,0.0,44,0
17,44297,-5818,544,6362,0.0,44,0
18,43834,-3848,174,4022,0.0,43,-1
19,42730,-1863,372,2235,0.0,43,0
20,41282,-1499,136,1635,1.7,43,0
21,41709,319,987,668,3.2,43,0
22,41433,-321,659,980,1.2,43,0
23,41883,348,1933,1585,2.9,43,0
24,41165,-840,916,1756,0.0,43,0
25,40552,-702,1090,1792,0.0,43,0
0,33257,0,0,0,1.7,60,0
1,38313,-781,5582,6363,1.2,60,0
2,32133,-7613,2956,10569,5.2,60,0
3,31637,-2055,3313,5368,0.4,59,-1
4,30130,-2589,3099,5688,0.0,59,0
5,26920,-3501,827,4328,6.1,59,0
6,24633,-2654,607,3261,0.7,58,-1
7,22523,-2269,379,2648,10.5,58,0
8,39069,14602,20431,5829,3.1,58,0
9,54472,13516,17934,4418,3.2,58,0
10,53674,-555,8973,9528,9.4,58,0
11,55789,2107,9092,6985,9.9,58,0
12,82667,25368,28538,3170,1.6,58,0
13,81768,-561,8744,9305,2.7,58,0
14,79042,-3508,7743,11251,6.9,58,0
15,72935,-6561,3338,9899,0.0,58,0
16,68649,-4896,5737,10633,5.8,58,0
17,81540,4986,15181,10195,5.6,58,0
18,66131,-7133,3619,10752,0.4,58,0
19,66084,-2613,6248,8861,3.4,58,0
20,58996,-7196,1375,8571,7.2,58,0
21,73779,13356,16297,2941,7.3,58,0
22,97951,22790,27896,5106,7.6,58,0
23,104241,5900,21598,15698,3.3,58,0
24,90639,-14552,4918,19470,0.7,58,0
25,87401,-4163,8982,13145,0.3,58,0
0,1176,1006,1303,297,0.0,45,0
1,2042,617,1005,388,0.5,45,0
2,7783,4902,5595,693,4.9,45,0
3,12295,4049,5607,1558,1.4,45,0
4,19505,6282,8855,2573,2.7,45,0
5,24715,4418,6253,1835,1.6,45,0
6,26071,1066,4035,2969,4.4,45,0
7,25770,314,3781,3467,1.0,45,0
8,27188,1088,2936,1848,0.0,45,0
9,24289,-2967,1354,4321,1.4,45,0
10,24339,-308,2922,3230,0.0,45,0
11,21662,-2743,826,3569,1.9,45,0
12,29167,6613,9428,2815,0.0,45,0
13,20684,-4943,1591,6534,0.0,45,0
14,17621,-5725,191,5916,0.0,45,0
15,15964,-2899,322,3221,0.0,45,0
16,14098,-1930,150,2080,1.4,45,0
17,14621,343,932,589,1.4,45,0
18,14191,-520,443,963,0.2,45,0
19,14561,234,1423,1189,4.4,45,0
20,14064,-658,550,1208,0.0,45,0
21,12415,-1694,398,2092,0.0,45,0
0,0,0,0,0,0.0,40,0
1,10197,7829,8467,638,0.0,40,0
2,15285,4325,5197,872,0.0,40,0
3,18524,2355,3637,1282,0.0,40,0
4,24158,4030,5399,1369,0.0,40,0
5,26632,2178,3071,893,0.0,40,0
6,29391,1495,2913,1418,0.0,40,0
7,31271,2256,3254,998,0.0,40,0
8,32670,1100,2023,923,0.0,40,0
9,34438,1683,2596,913,0.0,40,0
10,38173,2590,4003,1413,0.0,40,0
11,39351,1315,2517,1202,0.0,40,0
12,39967,380,2703,2323,0.0,40,0
13,71274,1497,4787,3290,0.0,40,0
14,42453,-249,2107,2356,0.0,40,0
15,41805,-426,1632,2058,0.0,40,0
16,41627,-356,863,1219,0.0,40,0
17,41446,-345,673,1018,0.0,40,0
18,40799,-808,634,1442,0.0,40,0
19,40422,-541,1468,2009,0.0,40,0
20,39351,-1314,498,1812,0.0,40,0
21,37936,-1515,797,2312,0.0,40,0
0,907,661,840,179,0.0,45,0
1,977,42,276,234,0.0,45,0
2,1577,358,496,138,0.0,45,0
3,2294,324,563,239,0.0,45,0
4,2475,57,283,226,0.0,45,0
5,2697,18,317,299,0.0,45,0
6,2815,-14,221,235,0.0,45,0
7,2860,-45,142,187,0.0,45,0
8,2907,-32,121,153,0.0,45,0
9,3030,-56,164,220,0.0,45,0
10,3047,-49,82,131,0.0,45,0
11,3147,-10,188,198,0.0,45,0
12,4096,127,493,366,0.0,45,0
13,3459,-78,133,211,0.0,45,0
14,3553,-61,193,254,0.0,45,0
15,3591,-47,86,133,0.0,45,0
16,3640,-36,84,120,0.0,45,0
17,3757,-10,169,179,0.0,45,0
18,3921,21,201,180,0.0,45,0
19,3948,-70,93,163,0.0,45,0
20,3993,-76,95,171,0.0,45,0
0,981,915,1495,580,0.0,60,0
1,2390,1342,1634,292,0.0,60,0
2,3110,615,1163,548,0.0,60,0
3,2841,-382,466,848,2.1,60,0
4,3215,231,1074,843,2.8,59,-1
5,2651,-589,319,908,6.7,59,0
6,9318,6123,7117,994,0.0,58,-1
0,0,0,0,0,0.0,40,0
0,3638,0,0,0,0.0,50,0
1,2957,-820,70,890,0.0,50,0
2,2767,-406,187,593,0.0,49,-1
3,3232,114,481,367,0.5,49,0
4,3565,30,456,426,0.0,49,0
5,3545,-154,200,354,0.6,49,0
6,3665,-28,205,233,2.8,49,0
7,3684,-59,187,246,0.0,49,0
8,3255,-432,49,481,0.0,49,0
9,3326,-15,112,127,0.6,49,0
10,3400,2,135,133,0.1,49,0
11,3224,-183,36,219,0.0,49,0
12,3054,-174,11,185,0.0,49,0
13,2961,-95,26,121,0.0,49,0
14,2833,-135,19,154,0.0,49,0
15,2740,-56,9,65,0.0,49,0
16,2646,-91,29,120,0.0,49,0
17,2575,-39,26,65,0.0,49,0
18,2546,-31,7,38,0.0,48,-1
19,2544,-7,16,23,0.0,48,0
20,2602,15,42,27,0.0,48,0
21,2683,17,72,55,0.0,48,0
22,2683,17,72,55,0.0,48,0
23,2720,6,57,51,0.0,48,0
24,2762,-2,57,59,0.0,48,0
0,99837,0,0,0,0.3,70,0
1,93723,-13639,2782,16421,3.1,70,0
2,79556,-16003,1036,17039,0.2,69,-1
3,74195,-6765,1479,8244,8.3,69,0
4,72496,-3118,2391,5509,0.0,69,0
5,70570,-2557,1785,4342,0.5,69,0
6,69410,-1747,1695,3442,9.4,68,-1
7,67724,-2010,1093,3103,2.2,68,0
8,66408,-1802,1048,2850,0.1,68,0
9,65025,-1600,601,2201,0.0,68,0
10,62911,-2278,355,2633,2.2,68,0
11,61515,-1602,289,1891,14.3,68,0
12,68762,6611,7458,847,6.2,68,0
13,77865,8639,10815,2176,7.1,68,0
14,98720,18492,23430,4938,9.0,68,0
15,160351,38788,48872,10084,2.9,68,0
16,201956,8155,34053,25898,1.8,68,0
17,122110,-12059,5279,17338,1.7,68,0
18,110518,-11795,1158,12953,1.5,68,0
19,102994,-7722,535,8257,8.3,68,0
20,103298,-166,3937,4103,0.2,68,0
21,149125,34407,43335,8928,3.6,68,0
22,149125,34407,43335,8928,3.2,68,0
23,115550,-23036,1824,24860,7.1,68,0
24,130125,12534,20346,7812,9.4,68,0
0,41401,0,0,0,4.3,50,0
1,117980,49538,67845,18307,2.3,50,0
2,131420,9004,32804,23800,5.0,50,0
3,193284,48071,63937,15866,2.6,50,0
4,157184,-30694,10310,41004,0.6,50,0
5,115234,-43621,1108,44729,0.0,50,0
6,80387,-36845,96,36941,0.0,50,0
7,69102,-11970,407,12377,4.5,49,-1
8,67333,-2266,6322,8588,0.0,49,0
9,57186,-10406,63,10469,0.0,49,0
10,49889,-7344,39,7383,0.0,48,-1
11,46458,-3874,49,3923,0.0,48,0
12,44824,-1708,63,1771,0.0,48,0
13,44854,-113,965,1078,0.0,48,0
14,49992,4395,5651,1256,0.4,48,0
15,50049,461,2245,1784,5.4,48,0
16,59377,2559,5767,3208,0.2,48,0
17,48291,-1214,858,2072,0.0,48,0
18,48059,-374,953,1327,1.8,48,0
19,47910,-285,711,996,0.0,48,0
20,46711,-1341,389,1730,0.0,48,0
21,47199,67,1789,1722,1.7,48,0
22,47199,67,1789,1722,2.9,48,0
23,46694,-512,751,1263,3.0,48,0
24,64034,15761,18450,2689,0.0,48,0
0,10689,0,0,0,0.0,60,0
1,11165,-1784,913,2697,0.0,60,0
2,9629,-2276,666,2942,0.0,59,-1
3,9184,-1061,700,1761,0.0,59,0
4,8576,-1076,464,1540,0.0,58,-1
5,8416,-455,295,750,4.5,58,0
6,8380,-296,296,592,2.1,58,0
7,8313,-239,241,480,9.6,58,0
8,11888,2531,3297,766,0.0,58,0
9,11384,-469,818,1287,0.2,58,0
10,10966,-623,527,1150,0.0,58,0
11,10392,-736,262,998,0.0,58,0
12,10234,-275,213,488,0.0,58,0
13,10003,-324,203,527,0.0,58,0
14,9889,-293,336,629,3.1,58,0
15,9855,-82,254,336,3.3,58,0
16,10742,206,679,473,0.0,58,0
17,9861,-286,135,421,0.0,57,-1
18,9751,-172,86,258,0.0,57,0
19,9659,-135,83,218,0.0,57,0
20,9600,-149,62,211,0.0,57,0
21,9992,182,493,311,2.2,57,0
22,9992,182,493,311,0.0,57,0
23,9883,-155,157,312,0.0,57,0
24,10022,28,391,363,0.0,57,0
0,397204,0,0,0,6.1,60,0
1,878954,275313,323021,47708,10.9,61,1
2,965634,43922,160549,116627,5.6,61,0
3,1119737,95825,150459,54634,4.0,61,0
4,1082084,-45422,98120,143542,7.2,61,0
5,1358086,236689,275939,39250,0.5,62,1
6,902771,-434149,26260,460409,0.0,62,0
7,885629,-35744,29131,64875,2.8,61,-1
8,982149,65487,109808,44321,11.0,61,0
9,827721,-130807,67628,198435,0.0,62,1
10,563548,-261832,984,262816,0.0,61,-1
11,488547,-88262,390,88652,0.0,61,0
12,451651,-38541,171,38712,0.0,61,0
13,425854,-26469,190,26659,0.0,60,-1
14,395503,-30122,669,30791,0.0,60,0
15,377231,-9501,462,9963,0.0,60,0
16,398596,1962,13339,11377,3.6,60,0
17,403214,15909,24647,8738,7.1,60,0
18,514112,106760,112508,5748,5.6,60,0
19,508466,-4383,16177,20560,5.7,61,1
20,525016,14277,30485,16208,1.3,61,0
21,602381,61671,94700,33029,0.4,61,0
22,602381,61671,94700,33029,1.8,61,0
23,564737,-24822,14072,38894,4.1,61,0
24,834717,244963,262448,17485,4.1,61,0
0,101537,0,0,0,2.6,50,0
1,145252,20084,33108,13024,10.2,50,0
2,284812,105206,138666,33460,1.8,50,0
3,312616,23250,47762,24512,0.9,50,0
4,299234,-15862,21908,37770,10.1,50,0
5,436920,117006,132389,15383,2.2,51,1
6,457550,21131,37022,15891,3.0,51,0
7,438545,-18114,12046,30160,0.9,51,0
8,449352,2432,29256,26824,1.1,51,0
9,430121,-17435,10662,28097,2.5,51,0
10,438177,-1702,22944,24646,2.2,51,0
11,386932,-43841,3101,46942,3.6,51,0
12,379891,-9546,4907,14453,6.3,51,0
13,401468,18161,25738,7577,2.3,51,0
14,432166,26500,43282,16782,2.6,51,0
15,476529,28757,47124,18367,0.0,51,0
16,470913,-21578,32590,54168,8.8,51,0
17,410520,-4265,24103,28368,2.2,51,0
18,427498,15021,29635,14614,2.5,51,0
19,404549,-22241,4499,26740,0.5,51,0
20,379459,-25976,4228,30204,5.8,51,0
21,476281,75530,92692,17162,2.8,51,0
22,476281,75530,92692,17162,2.4,51,0
23,420424,-36952,5434,42386,2.8,51,0
24,523466,92154,108895,16741,2.4,51,0
0,270083,0,0,0,3.9,50,0
1,617049,168928,207230,38302,1.4,50,0
2,642875,1562,88498,86936,0.4,50,0
3,659948,-7755,43162,50917,1.9,50,0
4,616643,-57681,33008,90689,4.3,50,0
5,614883,-18760,25171,43931,2.8,50,0
6,595560,-27043,8780,35823,0.0,50,0
7,537604,-58519,3357,61876,1.3,50,0
8,525236,-20299,12419,32718,2.7,49,-1
9,508548,-18209,5232,23441,4.0,49,0
10,511457,-3610,16662,20272,2.1,49,0
11,481383,-28570,3666,32236,1.8,49,0
12,476249,-7702,3859,11561,0.0,49,0
13,467766,-10565,7176,17741,1.2,48,-1
14,473293,912,15978,15066,1.2,48,0
15,468022,2296,16876,14580,2.8,48,0
16,509721,9504,34824,25320,1.5,48,0
17,438681,-9329,8000,17329,3.6,48,0
18,444209,3496,12123,8627,1.1,48,0
19,427223,-16966,2048,19014,0.0,48,0
20,390133,-36852,381,37233,0.0,48,0
21,362852,-26592,1021,27613,0.0,48,0
22,362852,-26592,1021,27613,3.0,48,0
23,358971,-6195,2668,8863,3.4,48,0
24,426041,58975,66451,7476,1.4,48,0
0,21001,0,0,0,2.7,55,0
1,32961,3676,7797,4121,3.0,55,0
2,32333,-2627,3986,6613,1.0,55,0
3,29624,-4013,3719,7732,0.0,55,0
4,23833,-6314,756,7070,1.6,55,0
5,24227,-603,1654,2257,0.0,55,0
6,23587,-1111,1029,2140,0.8,55,0
7,20736,-2892,331,3223,0.0,55,0
8,20064,-984,464,1448,0.0,54,-1
9,19559,-655,319,974,0.7,54,0
10,19020,-673,274,947,1.8,54,0
11,18930,-264,353,617,1.5,54,0
12,18785,-242,224,466,0.5,54,0
13,18643,-226,290,516,0.0,54,0
14,17758,-929,164,1093,0.8,53,-1
15,17565,-160,147,307,1.1,53,0
16,17654,-183,299,482,3.9,53,0
17,17282,-190,179,369,2.4,53,0
18,17208,-124,122,246,1.8,53,0
19,17097,-158,61,219,3.2,53,0
20,17001,-154,87,241,3.0,53,0
21,17516,338,650,312,1.2,53,0
22,17516,338,650,312,0.0,53,0
23,17184,-314,115,429,0.0,53,0
24,17302,37,357,320,1.4,53,0
0,10789,0,0,0,0.0,60,0
1,11246,-2245,641,2886,0.9,60,0
2,10421,-1782,500,2282,0.2,59,-1
3,10403,-750,608,1358,4.5,59,0
4,11514,31,1328,1297,0.2,59,0
5,12424,344,1532,1188,3.0,59,0
6,12488,-314,899,1213,1.6,59,0
7,12468,-365,659,1024,2.6,59,0
8,12423,-436,648,1084,2.5,59,0
9,13780,921,1672,751,3.1,59,0
10,13955,-55,1014,1069,7.7,59,0
11,13939,-208,866,1074,2.4,59,0
12,14823,636,1306,670,8.5,59,0
13,19905,4574,5502,928,3.9,59,0
14,22780,2202,4950,2748,4.1,59,0
15,22072,-152,1976,2128,0.0,59,0
16,21652,-1684,1703,3387,11.1,59,0
17,20469,-366,1605,1971,0.0,59,0
18,19377,-1180,467,1647,0.3,59,0
19,18914,-605,378,983,1.7,59,0
20,18351,-716,401,1117,0.0,59,0
21,19298,456,1820,1364,0.0,59,0
22,19298,456,1820,1364,2.4,59,0
23,17800,-1348,213,1561,0.0,59,0
24,17587,-440,493,933,0.5,59,0
0,109,0,0,0,0.0,50,0
1,136,-1,26,27,0.0,50,0
2,137,-13,30,43,0.0,50,0
3,137,-5,18,23,0.0,50,0
4,152,2,23,21,0.0,50,0
5,165,9,27,18,0.0,50,0
6,158,-10,10,20,0.0,50,0
7,161,-2,22,24,0.0,50,0
8,156,-5,18,23,0.0,50,0
9,157,0,10,10,0.0,50,0
10,177,18,38,20,0.0,50,0
11,200,23,50,27,0.0,50,0
12,183,-19,7,26,0.0,50,0
13,184,3,13,10,0.0,50,0
14,185,-1,17,18,0.0,50,0
15,195,1,13,12,0.0,50,0
16,210,12,20,8,0.0,50,0
17,221,8,30,22,0.0,50,0
18,226,2,15,13,0.0,50,0
19,227,-2,15,17,0.0,50,0
20,238,10,17,7,0.0,50,0
21,238,0,17,17,0.0,50,0
22,238,0,17,17,0.0,50,0
23,255,15,21,6,0.0,50,0
24,262,8,35,27,0.0,50,0
0,54492,0,0,0,2.5,55,0
1,92644,11979,19670,7691,2.9,55,0
2,102121,7,15442,15435,1.7,55,0
3,106524,-2299,8849,11148,9.8,55,0
4,140836,18505,34403,15898,1.0,55,0
5,160610,14554,25439,10885,3.7,55,0
6,172821,7794,16798,9004,0.9,55,0
7,163847,-9666,6352,16018,0.0,55,0
8,157450,-9531,7437,16968,2.9,55,0
9,152854,-5354,3990,9344,0.0,55,0
10,144640,-9201,4113,13314,2.5,55,0
11,136805,-8331,1236,9567,2.5,55,0
12,136260,-1472,1866,3338,5.4,55,0
13,141968,4527,7144,2617,9.2,55,0
14,211355,59442,64386,4944,2.6,55,0
15,283194,53285,65480,12195,3.6,56,1
16,355926,22636,53616,30980,2.5,56,0
17,248951,-20199,5583,25782,2.4,56,0
18,246907,-3469,7567,11036,4.2,56,0
19,236454,-10685,2466,13151,2.2,56,0
20,226657,-10579,2553,13132,0.0,55,-1
21,232027,833,16893,16060,0.0,55,0
22,232027,833,16893,16060,0.5,55,0
23,198760,-30007,1299,31306,0.0,55,0
24,161064,-37438,88,37526,0.0,55,0
0,8045,0,0,0,0.2,55,0
1,9223,-928,566,1494,0.0,55,0
2,8286,-1465,540,2005,0.0,54,-1
3,8331,-353,665,1018,2.3,54,0
4,8111,-594,472,1066,0.0,54,0
5,7715,-543,196,739,0.0,54,0
6,7501,-368,158,526,0.0,53,-1
7,7189,-387,104,491,0.0,53,0
8,6983,-312,120,432,1.3,53,0
9,6940,-141,95,236,2.7,53,0
10,6937,-101,113,214,0.0,53,0
11,6792,-177,75,252,0.0,53,0
12,6831,-11,137,148,0.0,52,-1
13,6827,-40,125,165,1.2,52,0
14,7056,114,343,229,1.4,52,0
15,7087,-61,137,198,2.1,52,0
16,7438,13,346,333,1.0,52,0
17,7114,-107,129,236,1.6,52,0
18,7051,-91,67,158,0.0,52,0
19,6969,-107,42,149,0.0,52,0
20,6915,-97,44,141,2.2,52,0
21,7030,27,193,166,1.1,52,0
22,7030,27,193,166,0.4,52,0
23,6981,-85,94,179,1.2,52,0
24,7272,198,320,122,0.0,52,0
0,387691,0,0,0,8.6,70,0
1,875767,331148,399696,68548,24.4,71,1
2,1922282,868743,969169,100426,8.7,73,1
3,2963753,940107,980349,40242,9.3,75,1
4,3660283,624975,708612,83637,9.3,76,1
5,4129459,420514,454325,33811,1.3,77,1
6,4154663,15941,125234,109293,17.6,77,0
7,4192051,28768,155125,126357,1.9,77,0
8,4362644,112176,220738,108562,16.1,78,1
9,4592948,205723,228542,22819,7.7,79,1
10,4719468,107896,189954,82058,15.5,80,1
11,4558764,-152458,77229,229687,2.8,80,0
12,4557081,-21832,57449,79281,8.1,79,-1
13,4648980,67501,113813,46312,1.8,79,0
14,4735999,61358,147853,86495,2.9,80,1
15,4431270,-69196,95444,164640,1.3,79,-1
16,2850579,-851564,65476,917040,0.0,78,-1
17,2148929,-181628,194104,375732,4.9,76,-1
18,3053662,884381,925888,41507,5.7,76,0
19,3063876,14147,160879,146732,14.5,76,0
20,3052717,-19382,112015,131397,9.1,76,0
21,3172004,116977,580206,463229,0.0,77,1
22,3172004,116977,580206,463229,0.0,77,0
23,2700453,-472130,40568,512698,1.4,77,0
24,3522058,765433,811559,46126,3.1,78,1
0,8203,0,0,0,0.0,50,0
1,5773,-2513,77,2590,0.0,50,0
2,4411,-1560,73,1633,0.0,49,-1
3,3804,-676,36,712,0.0,49,0
4,3431,-427,48,475,0.0,49,0
5,3201,-265,27,292,0.0,49,0
6,3057,-158,32,190,0.0,48,-1
7,2967,-101,46,147,2.2,48,0
8,4646,1137,1426,289,0.0,48,0
9,4730,66,482,416,4.0,48,0
10,6071,819,1262,443,0.0,48,0
11,5299,-600,230,830,2.3,48,0
12,5916,418,659,241,9.4,48,0
13,30465,22864,23974,1110,3.2,48,0
14,48646,16398,21175,4777,2.4,48,0
15,108462,46172,53530,7358,5.6,48,0
16,165687,18895,38165,19270,0.5,48,0
17,84799,-12815,1547,14362,2.6,48,0
18,81594,-3634,2851,6485,0.0,48,0
19,71437,-10197,287,10484,0.9,48,0
20,64311,-7388,455,7843,2.0,48,0
21,66393,1470,6586,5116,5.4,48,0
22,66393,1470,6586,5116,1.6,48,0
23,62086,-4272,1525,5797,0.9,48,0
24,86995,22884,28183,5299,1.9,48,0
0,583310,0,0,0,10.7,80,0
1,728227,55242,144955,89713,14.1,80,0
2,777072,16344,114962,98618,7.0,80,0
3,705312,-79732,90791,170523,0.9,80,0
4,578039,-135330,30176,165506,2.4,79,-1
5,352665,-228244,1848,230092,0.0,79,0
6,298373,-62633,544,63177,0.0,78,-1
7,274181,-25485,638,26123,0.0,78,0
8,310046,28106,41651,13545,9.8,78,0
9,327624,17025,26103,9078,9.8,78,0
10,348433,16798,33073,16275,8.9,78,0
11,330995,-14787,11741,26528,7.3,78,0
12,322665,-10054,5675,15729,5.2,78,0
13,346508,20903,27795,6892,1.3,78,0
14,325375,-21250,18661,39911,0.0,78,0
15,298967,3990,15305,11315,5.0,78,0
16,326414,8319,29716,21397,0.2,78,0
17,327505,13156,29321,16165,3.4,78,0
18,372154,42717,53463,10746,5.3,78,0
19,363739,-8533,13109,21642,0.8,78,0
20,340567,-24407,5049,29456,2.0,78,0
21,714218,326154,347604,21450,0.7,79,1
22,714218,326154,347604,21450,6.9,79,0
23,536131,-135370,21904,157274,5.4,79,0
24,648119,100969,139621,38652,9.4,79,0
0,5051,0,0,0,0.0,45,0
1,5940,-486,136,622,0.0,45,0
2,6035,-542,127,669,0.0,45,0
3,5973,-365,89,454,0.0,45,0
4,6015,-305,176,481,0.0,44,-1
5,5957,-207,107,314,0.0,44,0
6,5931,-128,67,195,0.0,44,0
7,5856,-131,45,176,0.0,44,0
8,5781,-147,63,210,0.0,44,0
9,5711,-121,23,144,0.0,44,0
10,5671,-99,43,142,0.0,44,0
11,5659,-59,61,120,0.0,44,0
12,5595,-87,16,103,0.0,44,0
13,5575,-55,35,90,0.0,44,0
14,5562,-77,51,128,0.0,43,-1
15,5547,-70,33,103,0.0,43,0
16,5609,-60,103,163,0.0,43,0
17,5467,-76,23,99,0.0,43,0
18,5463,-27,20,47,0.0,43,0
19,5470,-13,32,45,0.0,43,0
20,5523,15,88,73,0.0,43,0
21,5532,-31,80,111,0.0,43,0
22,5532,-31,80,111,0.0,43,0
23,5615,32,111,79,0.0,43,0
24,5592,-62,100,162,0.0,43,0
0,75335,0,0,0,2.1,55,0
1,133590,19148,36189,17041,3.1,55,0
2,123385,-16720,17310,34030,3.0,55,0
3,100840,-26221,9196,35417,0.0,55,0
4,81806,-21754,2728,24482,0.5,54,-1
5,80639,-3591,3433,7024,1.7,54,0
6,79838,-2193,2792,4985,5.0,54,0
7,76817,-3643,2162,5805,2.4,54,0
8,73448,-4088,2511,6599,1.2,53,-1
9,72814,-1387,1509,2896,5.0,53,0
10,71243,-1957,1541,3498,3.2,53,0
11,69222,-2376,823,3199,1.5,53,0
12,68986,-499,1006,1505,1.8,53,0
13,64440,-4527,235,4762,0.0,53,0
14,58685,-5763,52,5815,0.0,53,0
15,55670,-1605,34,1639,0.0,53,0
16,53311,-2257,47,2304,0.0,52,-1
17,51729,-1168,26,1194,0.0,52,0
18,51167,-597,17,614,0.0,52,0
19,50612,-565,12,577,0.0,52,0
20,49893,-721,26,747,0.0,52,0
21,49280,-628,26,654,0.0,52,0
22,49280,-628,26,654,0.0,52,0
23,49129,-223,88,311,0.0,52,0
24,49138,-91,188,279,1.2,52,0
0,471986,0,0,0,9.9,75,0
1,914403,277021,363416,86395,10.6,75,0
2,1747659,682098,806071,123973,8.1,76,1
3,2138184,345974,455685,109711,17.5,77,1
4,2994469,735240,817940,82700,8.9,79,1
5,2822056,-143019,280064,423083,6.6,80,1
6,2489808,-353780,81447,435227,0.0,80,0
7,2138472,-355574,43512,399086,1.3,79,-1
8,2246665,50477,217058,166581,5.8,79,0
9,2141893,-92342,97384,189726,10.8,79,0
10,1865949,-276405,52014,328419,8.0,78,-1
11,1393862,-480284,12766,493050,0.0,77,-1
12,1088034,-313573,1062,314635,0.0,77,0
13,908561,-184755,761,185516,0.0,77,0
14,771233,-137237,1041,138278,0.0,77,0
15,686522,-43010,484,43494,0.4,77,0
16,718228,1361,28744,27383,4.2,77,0
17,669786,-3478,16556,20034,5.0,77,0
18,726110,52491,62552,10061,4.7,77,0
19,711837,-13664,12897,26561,0.0,77,0
20,685612,-27273,7856,35129,5.2,77,0
21,887185,162928,192296,29368,3.5,77,0
22,887185,162928,192296,29368,0.2,77,0
23,756265,-95866,6764,102630,5.1,77,0
24,842022,76569,104236,27667,0.0,77,0
0,143040,0,0,0,6.9,55,0
1,172602,9014,34383,25369,0.9,55,0
2,130294,-43447,7437,50884,5.2,55,0
3,119765,-14841,8995,23836,6.9,55,0
4,108798,-13885,9049,22934,2.6,54,-1
5,101034,-9583,4851,14434,1.6,54,0
6,94028,-8040,2723,10763,5.5,54,0
7,85160,-9127,1458,10585,3.8,53,-1
8,77615,-7885,1852,9737,10.2,53,0
9,88271,8449,11709,3260,3.6,53,0
10,87457,-768,6553,7321,4.5,53,0
11,82413,-4890,2583,7473,1.8,53,0
12,80253,-2506,1828,4334,2.2,53,0
13,79540,-1091,3113,4204,1.3,53,0
14,78512,-1503,3763,5266,3.9,53,0
15,77942,-532,3133,3665,3.3,53,0
16,83495,-462,5840,6302,1.4,53,0
17,58746,-9225,51,9276,0.0,52,-1
18,56889,-2064,264,2328,4.9,52,0
19,56125,-848,310,1158,4.3,52,0
20,55200,-1006,337,1343,9.9,52,0
21,82664,23030,26198,3168,1.3,52,0
22,82664,23030,26198,3168,1.2,52,0
23,68464,-10129,925,11054,2.2,52,0
24,73600,4303,8582,4279,2.3,52,0
0,0,0,0,0,0.0,40,0
1,5520,3139,4013,874,0.0,40,0
2,7866,1495,2610,1115,0.0,40,0
3,11222,2464,3376,912,2.0,40,0
4,14582,2460,4002,1542,0.0,40,0
5,15963,654,2737,2083,0.0,40,0
6,23307,6308,7932,1624,0.0,40,0
7,23593,287,2608,2321,0.0,40,0
8,22501,-1110,1172,2282,0.0,40,0
9,21589,-1136,597,1733,0.0,40,0
10,20738,-1052,619,1671,0.0,40,0
11,20387,-814,1093,1907,0.0,40,0
12,18624,-1293,385,1678,0.0,40,0
13,20036,-781,1165,1946,0.0,40,0
14,16134,-1333,313,1646,0.0,40,0
15,14830,-1313,43,1356,0.0,40,0
16,13961,-897,35,932,0.0,40,0
17,13327,-691,118,809,0.0,40,0
18,13339,-229,392,621,0.0,40,0
19,13339,-229,392,621,0.0,40,0
20,13413,-109,309,418,0.0,40,0
21,13314,-318,307,625,0.0,40,0
0,1969,1331,1646,315,3.1,50,0
1,3887,1469,1934,465,1.3,50,0
2,5307,1028,1526,498,0.0,50,0
3,3894,-1346,198,1544,0.0,50,0
4,4175,-105,558,663,1.3,50,0
5,4834,401,804,403,2.6,50,0
6,6661,1205,1964,759,2.8,50,0
7,5761,-620,501,1121,1.5,50,0
8,7087,1053,1512,459,0.9,50,0
9,10672,3224,3890,666,2.8,50,0
10,18416,6633,8400,1767,3.2,50,0
11,23570,3833,5939,2106,1.4,50,0
12,27249,403,4653,4250,1.5,50,0
13,18310,-1915,639,2554,2.9,50,0
14,18569,65,1211,1146,0.0,50,0
15,16968,-1665,282,1947,5.2,50,0
16,17664,436,1512,1076,1.3,50,0
17,25145,5988,7549,1561,3.9,50,0
18,25145,5988,7549,1561,2.5,50,0
19,23392,-928,1661,2589,2.3,50,0
20,36310,11547,13596,2049,3.2,50,0
0,1460,906,1203,297,0.0,45,0
1,1977,252,441,189,0.0,45,0
2,2245,-4,212,216,1.9,45,0
3,3803,1130,1455,325,0.0,45,0
4,4074,-44,456,500,0.0,45,0
5,4006,-220,120,340,0.0,45,0
6,3993,-201,164,365,0.0,45,0
7,4045,-121,182,303,0.0,45,0
8,3909,-209,48,257,1.7,45,0
9,4782,664,883,219,0.0,45,0
10,4976,-79,413,492,0.0,45,0
11,4977,-120,242,362,0.0,45,0
12,7301,220,825,605,0.0,45,0
13,5228,-152,138,290,0.0,45,0
14,5386,79,253,174,0.0,45,0
15,5620,149,329,180,4.4,45,0
16,6841,972,1337,365,2.1,45,0
17,12145,4155,5478,1323,0.4,45,0
18,12145,4155,5478,1323,0.0,45,0
19,10725,-957,599,1556,0.0,45,0
20,9295,-1558,255,1813,0.0,45,0
0,0,0,0,0,0.0,45,0
1,13,6,13,7,0.0,45,0
2,32,9,18,9,0.0,45,0
3,70,19,33,14,0.0,45,0
4,117,19,47,28,0.0,45,0
5,117,19,47,28,0.0,45,0
6,169,36,66,30,0.0,45,0
7,193,4,66,62,0.0,45,0
0,2043,1970,2050,80,0.0,55,0
1,5412,3017,3735,718,0.3,55,0
2,20824,13825,15935,2110,0.4,55,0
3,20824,13825,15935,2110,0.2,55,0
4,14102,-5619,1789,7408,0.0,55,0
5,10227,-4012,1495,5507,0.1,54,-1
0,0,0,0,0,0.0,40,0
0,0,0,0,0,0.0,45,0
0,0,0,0,0,0.0,40,0
0,10507,0,0,0,0.0,60,0
1,13079,-535,1087,1622,0.0,60,0
2,12237,-1848,759,2607,0.0,60,0
3,10877,-1580,278,921,0.0,59,-1
4,12744,1296,2511,1215,6.2,59,0
5,13900,797,1868,1071,1.7,59,0
6,14204,18,1238,1220,0.0,59,0
7,13066,-1243,438,1681,2.0,59,0
8,12200,-1208,335,1543,6.8,59,0
9,13641,1065,1608,543,2.8,59,0
10,13847,70,1026,956,1.0,59,0
11,14074,-22,816,838,1.9,59,0
12,16050,1685,2285,600,2.5,59,0
13,16818,657,1557,900,0.3,59,0
14,16033,-940,772,1712,2.4,59,0
15,13707,-1640,283,1923,7.4,59,0
16,13081,-845,105,950,0.0,59,0
17,13081,-845,105,950,5.3,59,0
18,13769,423,1021,598,4.1,59,0
19,13737,-117,463,580,6.5,59,0
20,13626,-203,350,553,2.5,59,0
21,13666,-109,425,534,5.3,59,0
22,18650,2747,3793,1046,3.0,59,0
23,18650,2747,3793,1046,3.1,59,0
24,15872,-931,1000,1931,9.3,59,0
25,15698,-385,907,1292,4.8,59,0
0,117641,0,0,0,0.0,40,0
1,131318,-825,6570,7395,0.0,40,0
2,131574,-3196,5791,8987,0.0,40,0
3,131330,-2093,3381,5474,0.0,40,0
4,131159,-1511,6103,7614,0.0,40,0
5,131773,-101,4087,4188,0.0,40,0
6,130407,-1683,1477,3160,0.0,40,0
7,129323,-1369,1331,2700,0.0,40,0
8,129292,-453,2772,3225,0.0,40,0
9,128804,-833,1245,2078,0.0,40,0
10,127668,-1532,1881,3413,0.0,40,0
11,127040,-882,1360,2242,0.0,40,0
12,126487,-714,926,1640,0.0,40,0
13,126441,-191,1555,1746,0.0,40,0
14,126636,-186,1878,2064,0.0,40,0
15,131582,-3269,2051,5320,0.0,40,0
16,117576,-3351,1442,4793,0.0,40,0
17,117576,-3351,1442,4793,0.0,40,0
18,114933,-2716,767,3483,0.0,40,0
19,113469,-1529,505,2034,0.0,40,0
20,112552,-975,452,1427,0.0,40,0
21,110794,-1814,419,2233,0.0,40,0
22,134896,18516,23359,4843,0.0,39,-1
23,134896,18516,23359,4843,0.0,39,0
24,147522,14534,19006,4472,0.0,39,0
25,184334,29734,38975,9241,0.0,39,0
0,19025,0,0,0,1.7,55,0
1,17689,-2919,670,3589,0.0,55,0
2,13733,-4228,392,4620,6.2,54,-1
3,11811,-2169,256,2425,1.7,54,0
4,10081,-1854,173,2027,8.3,53,-1
5,9395,-825,152,977,15.7,53,0
6,11567,1665,2331,666,5.4,53,0
7,12331,629,1897,1268,7.4,53,0
8,13652,960,2649,1689,4.6,53,0
9,13672,38,1133,1095,0.0,53,0
10,12290,-1324,274,1598,0.4,53,0
11,11442,-987,100,1087,0.0,53,0
12,10830,-659,69,728,0.0,53,0
13,10200,-650,52,702,5.9,53,0
14,9776,-446,142,588,0.0,53,0
15,8653,-413,101,514,0.0,52,-1
16,8343,-413,39,452,0.0,52,0
17,8343,-413,39,452,0.0,52,0
18,7883,-508,195,703,0.0,52,0
19,7426,-467,26,493,0.0,52,0
20,7249,-189,108,297,0.0,52,0
21,6965,-284,31,315,0.0,52,0
22,6814,-158,84,242,0.0,52,0
23,6814,-158,84,242,0.0,52,0
24,6765,-56,146,202,0.0,52,0
25,6539,-222,17,239,0.0,52,0
0,10082,0,0,0,1.7,45,0
1,15000,-430,1394,1824,0.0,45,0
2,13117,-2245,338,2583,1.4,45,0
3,12278,-1215,255,1470,2.3,44,-1
4,12490,-281,1130,1411,1.9,44,0
5,13394,606,1681,1075,1.5,44,0
6,13874,208,1490,1282,0.0,44,0
7,12417,-1322,156,1478,0.0,44,0
8,11541,-946,79,1025,0.0,44,0
9,11015,-597,38,635,0.0,44,0
10,10586,-504,112,616,0.0,43,-1
11,10275,-384,73,457,0.0,43,0
12,10078,-240,65,305,0.0,43,0
13,9853,-258,84,342,0.0,43,0
14,9636,-282,145,427,0.0,43,0
15,9604,-130,250,380,0.0,42,-1
16,9226,-117,132,249,0.0,42,0
17,9226,-117,132,249,0.0,42,0
18,9061,-192,84,276,0.0,42,0
19,8960,-121,49,170,0.0,42,0
20,8865,-119,31,150,0.0,42,0
21,8820,-81,67,148,0.0,42,0
22,8754,-108,87,195,0.0,42,0
23,8754,-108,87,195,0.0,42,0
24,8706,-65,71,136,0.0,42,0
25,8601,-131,72,203,0.0,42,0
0,19305,0,0,0,1.7,45,0
1,20066,-2290,1162,3452,4.1,45,0
2,18392,-2659,1201,3860,0.9,45,0
3,16559,-2225,514,2739,0.0,44,-1
4,14915,-1947,402,2349,0.0,44,0
5,13882,-1202,246,1448,0.0,44,0
6,13259,-813,367,1180,0.0,43,-1
7,12639,-687,281,968,0.0,43,0
8,12060,-677,208,885,0.0,43,0
9,11687,-468,99,567,0.0,43,0
10,11529,-257,320,577,0.0,42,-1
11,11553,-93,490,583,0.0,42,0
12,11468,-149,281,430,0.0,42,0
13,11463,-61,394,455,0.2,42,0
14,11449,-102,575,677,0.0,42,0
15,10806,-296,248,544,0.0,42,0
16,10684,-155,130,285,0.0,42,0
17,10684,-155,130,285,0.0,42,0
18,10479,-280,104,384,0.0,42,0
19,10376,-142,83,225,0.0,42,0
20,10277,-125,70,195,0.0,42,0
21,10210,-107,111,218,0.0,42,0
22,10073,-203,130,333,0.0,42,0
23,10073,-203,130,333,0.0,42,0
24,10118,2,186,184,0.0,41,-1
25,10233,41,341,300,0.0,41,0
0,8412,0,0,0,0.2,55,0
1,9284,-835,1715,2550,5.2,55,0
2,13139,1979,5379,3400,4.0,55,0
3,10928,-2191,725,2916,0.9,55,0
4,10224,-1148,1356,2504,0.0,55,0
5,9575,-826,992,1818,0.0,54,-1
6,8561,-1157,490,1647,8.9,54,0
7,10890,1789,2777,988,6.3,53,-1
8,11595,473,2187,1714,9.5,53,0
9,13987,1983,3228,1245,1.9,53,0
10,20122,5167,7431,2264,1.0,53,0
11,24934,4809,8258,3449,8.6,53,0
12,54282,26339,29059,2720,0.7,53,0
13,47781,-4409,7438,11847,1.0,53,0
14,57846,8289,16998,8709,0.3,53,0
15,66360,6277,20417,14140,4.4,53,0
16,94254,23585,36839,13254,3.0,53,0
17,94254,23585,36839,13254,0.0,53,0
18,77479,-10737,8015,18752,4.0,53,0
19,74812,-3089,7938,11027,7.7,53,0
20,80913,5544,13153,7609,2.3,53,0
21,73965,-6957,5239,12196,5.0,53,0
22,120707,35247,46782,11535,6.2,53,0
23,120707,35247,46782,11535,0.8,53,0
24,103269,-7207,14107,21314,0.1,53,0
25,102509,-1714,22717,24431,3.6,53,0
0,60330,0,0,0,1.5,50,0
1,58925,-9330,2246,11576,2.1,50,0
2,58092,-4217,5221,9438,6.7,50,0
3,49217,-8834,1182,10016,3.3,49,-1
4,45392,-5061,2027,7088,0.0,49,0
5,41088,-4565,828,5393,0.0,49,0
6,37473,-4015,659,4674,0.2,48,-1
7,34590,-3015,275,3290,0.0,48,0
8,31915,-2823,184,3007,0.0,47,-1
9,30471,-1634,166,1800,0.0,47,0
10,29287,-1275,179,1454,0.0,47,0
11,28308,-1169,103,1272,0.2,47,0
12,27767,-603,182,785,0.0,47,0
13,27152,-688,152,840,0.0,46,-1
14,26493,-764,200,964,0.0,46,0
15,24858,-703,227,930,0.0,46,0
16,24742,-307,167,474,0.4,46,0
17,24742,-307,167,474,2.8,46,0
18,24551,-336,244,580,0.3,46,0
19,24474,-148,198,346,0.0,46,0
20,24163,-351,60,411,0.0,46,0
21,23971,-268,120,388,0.0,46,0
22,24208,-135,433,568,0.0,46,0
23,24208,-135,433,568,0.0,46,0
24,23820,-193,267,460,0.0,46,0
25,23563,-331,175,506,0.0,46,0
0,1435176,0,0,0,1.0,60,0
1,1290155,-202045,59667,261712,15.9,60,0
2,1458252,97227,272639,175412,5.7,60,0
3,1212856,-235871,50703,286574,6.3,60,0
4,937007,-285682,32853,318535,3.7,59,-1
5,760504,-186345,20218,206563,10.0,59,0
6,639346,-129173,17346,146519,7.4,58,-1
7,583982,-56761,11555,68316,5.0,58,0
8,488030,-95375,9965,105340,4.5,57,-1
9,439047,-53834,4196,58030,1.5,57,0
10,398813,-41679,7273,48952,0.0,56,-1
11,363720,-37505,4022,41527,0.0,56,0
12,338704,-25737,1669,27406,1.8,56,0
13,328483,-11205,3954,15159,2.5,55,-1
14,318571,-10511,4902,15413,0.5,55,0
15,302992,-4862,8906,13768,0.0,55,0
16,292574,-8490,2175,10665,0.0,55,0
17,292574,-8490,2175,10665,0.3,55,0
18,287448,-6477,3523,10000,2.5,55,0
19,286055,-1810,3410,5220,11.6,55,0
20,291150,4482,8350,3868,4.7,55,0
21,289748,-1602,4481,6083,2.6,55,0
22,303302,8655,17093,8438,0.0,55,0
23,303302,8655,17093,8438,0.0,55,0
24,281000,-17821,1070,18891,0.0,55,0
25,271698,-9469,1342,10811,0.1,55,0
0,27465,0,0,0,1.8,45,0
1,36857,324,4366,4042,0.0,45,0
2,32602,-4978,672,5650,0.0,45,0
3,30371,-2901,252,3153,0.0,45,0
4,29331,-1890,1344,3234,0.0,44,-1
5,28914,-774,1389,2163,0.0,44,0
6,28308,-836,707,1543,0.0,44,0
7,27713,-729,556,1285,0.0,44,0
8,26853,-980,366,1346,0.0,44,0
9,26288,-660,153,813,0.0,44,0
10,25569,-784,232,1016,0.0,44,0
11,25361,-389,361,750,0.0,43,-1
12,25139,-293,273,566,0.0,43,0
13,24922,-294,289,583,0.0,43,0
14,24848,-221,509,730,0.0,43,0
15,23887,-592,342,934,0.0,43,0
16,23303,-401,270,671,0.0,43,0
17,23303,-401,270,671,0.0,43,0
18,22966,-428,164,592,0.0,43,0
19,22787,-208,128,336,0.0,43,0
20,22578,-236,72,308,0.0,43,0
21,22339,-279,110,389,0.0,43,0
22,22037,-380,178,558,0.0,43,0
23,22037,-380,178,558,0.0,43,0
24,21906,-181,154,335,0.0,43,0
25,21546,-389,156,545,0.0,43,0
0,7285,0,0,0,3.4,55,0
1,9992,-711,821,1532,4.0,55,0
2,9411,-1109,870,1979,7.5,55,0
3,8782,-906,493,1399,0.4,55,0
4,7981,-1002,295,1297,5.1,54,-1
5,7575,-506,171,677,0.0,54,0
6,7045,-589,88,677,0.1,54,0
7,6653,-428,49,477,0.8,53,-1
8,6344,-372,47,419,6.7,53,0
9,6176,-198,48,246,8.7,53,0
10,6852,546,830,284,3.8,53,0
11,6922,59,418,359,11.5,53,0
12,13315,6103,6474,371,6.6,53,0
13,15553,2278,3384,1106,0.0,53,0
14,11815,-3625,228,3853,2.4,53,0
15,8547,-574,696,1270,7.2,53,0
16,13759,3039,4766,1727,6.2,53,0
17,13759,3039,4766,1727,3.2,53,0
18,12929,-209,1987,2196,5.4,53,0
19,12127,-854,1108,1962,6.3,53,0
20,11665,-546,953,1499,0.2,53,0
21,10670,-1012,659,1671,7.1,53,0
22,17800,4461,6346,1885,0.7,53,0
23,17800,4461,6346,1885,3.4,53,0
24,11646,-3635,500,4135,1.8,53,0
25,10611,-1122,605,1727,5.2,53,0
0,11895,0,0,0,1.1,50,0
1,12390,-1116,987,2103,1.0,50,0
2,10371,-2284,499,2783,0.0,50,0
3,8771,-1754,197,1951,0.0,49,-1
4,6967,-1914,98,2012,0.0,48,-1
5,5692,-1348,118,1466,0.0,48,0
6,4634,-1096,11,1107,0.0,48,0
7,4085,-557,18,575,0.0,47,-1
8,3690,-418,89,507,0.0,47,0
9,3456,-253,20,273,0.0,47,0
10,3421,-45,174,219,0.0,47,0
11,3406,-21,236,257,0.0,47,0
12,3192,-209,5,214,0.0,47,0
13,3117,-81,8,89,0.0,47,0
14,3027,-86,24,110,0.0,47,0
15,2840,-82,21,103,0.0,46,-1
16,2881,13,64,51,0.1,46,0
17,2881,13,64,51,0.0,46,0
18,2895,-11,67,78,0.0,46,0
19,2892,-10,44,54,0.0,46,0
20,2923,5,53,48,0.0,46,0
21,2942,0,63,63,0.0,46,0
22,2973,-5,67,72,0.0,46,0
23,2973,-5,67,72,0.0,46,0
24,2977,-8,78,86,0.0,46,0
25,2988,-25,67,92,0.0,46,0
0,50068,0,0,0,2.6,45,0
1,49386,-3551,3242,6793,8.6,45,0
2,198054,121526,172609,51083,4.9,45,0
3,197027,6905,28736,21831,3.6,45,0
4,175529,-19996,9850,29846,4.2,45,0
5,167439,-10210,7135,17345,2.7,45,0
6,159345,-8998,3148,12146,6.1,45,0
7,149794,-9502,2761,12263,2.5,45,0
8,138487,-10692,3321,14013,1.5,45,0
9,134565,-5525,2231,7756,4.5,45,0
10,137107,1072,10699,9627,5.5,45,0
11,148858,10738,17933,7195,2.1,45,0
12,159940,10835,16544,5709,2.3,45,0
13,165250,4898,12360,7462,3.2,45,0
14,200305,31733,42565,10832,8.4,45,0
15,174413,-13749,14451,28200,5.9,45,0
16,180783,-8548,14785,23333,1.5,45,0
17,180783,-8548,14785,23333,3.8,45,0
18,175524,-5937,16213,22150,1.4,45,0
19,154075,-21457,6436,27893,3.7,45,0
20,143468,-10971,4115,15086,3.5,45,0
21,133048,-10567,2537,13104,1.3,45,0
22,125962,-7235,6147,13382,0.3,45,0
23,125962,-7235,6147,13382,1.7,45,0
24,117693,-8718,3108,11826,2.2,45,0
25,120177,1295,10972,9677,0.5,45,0
0,64140,0,0,0,1.7,45,0
1,85536,8455,21059,12604,3.4,45,0
2,90909,1268,20474,19206,0.0,45,0
3,78731,-11077,2934,14011,0.0,45,0
4,59038,-19492,294,19786,0.0,45,0
5,50492,-9389,253,9642,2.9,45,0
6,49566,-1767,1093,2860,1.6,45,0
7,46590,-2917,454,3371,4.0,45,0
8,42297,-4332,680,5012,3.3,45,0
9,41690,-1069,860,1929,3.7,45,0
10,41928,-354,2503,2857,3.6,44,-1
11,44440,2200,4554,2354,0.1,44,0
12,46041,1537,3369,1832,0.8,44,0
13,47967,1724,3835,2111,0.0,44,0
14,49536,1084,4603,3519,1.3,44,0
15,48570,-2320,3097,5417,3.7,44,0
16,50596,1517,6196,4679,4.2,44,0
17,50596,1517,6196,4679,2.9,44,0
18,48369,-1133,4247,5380,1.4,44,0
19,43843,-4484,1023,5507,3.6,44,0
20,42123,-1895,974,2869,5.6,44,0
21,39720,-2420,319,2739,3.9,44,0
22,39052,-868,1743,2611,5.2,44,0
23,39052,-868,1743,2611,2.1,44,0
24,39087,-102,1980,2082,2.8,44,0
25,44804,4856,8027,3171,3.7,44,0
0,7957,0,0,0,0.0,45,0
1,7841,-1327,122,1449,0.0,45,0
2,7229,-1137,265,1402,0.0,44,-1
3,6897,-598,277,875,6.8,44,0
4,7313,-21,784,805,3.1,44,0
5,7799,276,840,564,9.6,44,0
6,8368,331,925,594,3.5,44,0
7,10029,1241,1965,724,2.5,44,0
8,10384,174,1067,893,6.5,44,0
9,10040,-388,384,772,6.8,44,0
10,10056,-121,485,606,2.5,44,0
11,9931,-248,348,596,4.7,44,0
12,11623,1418,1854,436,4.7,44,0
13,12893,1202,1849,647,2.5,44,0
14,13592,440,1687,1247,6.8,44,0
15,19012,900,3603,2703,6.6,44,0
16,21345,2708,4916,2208,4.0,44,0
17,21345,2708,4916,2208,0.0,44,0
18,15869,-4309,344,4653,0.0,44,0
19,15594,-434,602,1036,1.1,44,0
20,15259,-404,388,792,5.1,44,0
21,14854,-466,405,871,2.5,44,0
22,18499,2581,3435,854,0.0,44,0
23,18499,2581,3435,854,0.1,44,0
24,16523,-1145,562,1707,4.2,44,0
25,17973,1105,2399,1294,1.4,44,0
0,76220,0,0,0,0.0,45,0
1,69670,-10269,3063,13332,0.3,45,0
2,61159,-10112,3646,13758,0.0,45,0
3,50917,-10323,671,10994,0.0,45,0
4,38955,-12140,321,12461,1.1,45,0
5,36144,-3562,867,4429,1.7,45,0
6,34666,-1732,583,2315,2.5,45,0
7,32208,-2449,247,2696,0.0,45,0
8,27789,-4157,47,4204,2.8,45,0
9,27337,-908,341,1249,0.2,45,0
10,26173,-1217,435,1652,1.5,45,0
11,25578,-787,273,1060,1.0,45,0
12,25344,-300,434,734,0.4,45,0
13,24870,-535,290,825,3.8,45,0
14,23819,-1061,553,1614,0.0,45,0
15,21713,-767,437,1204,0.0,45,0
16,20721,-1074,82,1156,0.0,45,0
17,20721,-1074,82,1156,1.4,45,0
18,20057,-869,87,956,0.2,45,0
19,19291,-787,56,843,1.0,45,0
20,18874,-449,80,529,0.9,45,0
21,18464,-443,80,523,2.2,45,0
22,18276,-242,281,523,2.4,45,0
23,18276,-242,281,523,1.4,45,0
24,18147,-179,229,408,2.0,45,0
25,18123,-105,355,460,0.0,45,0
0,71203,0,0,0,0.0,45,0
1,87432,-4124,9436,13560,2.4,45,0
2,94818,-2084,14452,16536,1.9,45,0
3,89827,-7566,4123,11689,2.6,45,0
4,94310,-795,9526,10321,3.4,45,0
5,96163,170,7328,7158,5.9,45,0
6,98365,396,5597,5201,1.0,45,0
7,99407,-182,4889,5071,4.2,45,0
8,101083,-196,5506,5702,3.0,45,0
9,100136,-1755,2582,4337,1.7,45,0
10,98750,-2167,2849,5016,3.4,45,0
11,99117,-954,2994,3948,3.1,45,0
12,104244,3599,6176,2577,2.7,45,0
13,110969,5855,8668,2813,3.0,45,0
14,117635,4693,10210,5517,0.9,45,0
15,190931,20753,40247,19494,3.4,45,0
16,204173,34034,49429,15395,3.7,45,0
17,204173,34034,49429,15395,1.8,45,0
18,224178,23104,39496,16392,3.8,45,0
19,261297,34161,40783,6622,1.1,45,0
20,255395,-5529,8453,13982,2.4,45,0
21,257890,928,12386,11458,1.1,45,0
22,296403,29250,41659,12409,1.5,45,0
23,296403,29250,41659,12409,1.3,45,0
24,319873,27100,40126,13026,1.9,45,0
25,383375,58852,81211,22359,0.6,45,0
0,7610,0,0,0,0.0,45,0
1,8838,-1114,671,1785,7.4,45,0
2,13207,2116,4511,2395,5.0,45,0
3,9957,-2929,425,3354,0.0,45,0
4,7689,-2393,57,2450,0.0,44,-1
5,6781,-1031,52,1083,0.0,44,0
6,6043,-793,61,854,0.0,44,0
7,5422,-623,23,646,0.0,44,0
8,5092,-339,84,423,0.0,43,-1
9,4898,-216,41,257,0.0,43,0
10,4842,-60,165,225,0.0,43,0
11,4678,-184,72,256,0.0,43,0
12,4572,-113,19,132,0.0,43,0
13,4484,-91,18,109,0.0,43,0
14,4399,-87,55,142,0.0,43,0
15,4360,-42,91,133,4.0,43,0
16,4785,355,578,223,3.7,43,0
17,4785,355,578,223,7.4,43,0
18,5791,970,1515,545,4.7,43,0
19,6902,1014,1340,326,0.5,43,0
20,6561,-330,301,631,1.8,43,0
21,6444,-202,312,514,2.8,43,0
22,15060,5850,6891,1041,1.4,43,0
23,15060,5850,6891,1041,1.4,43,0
24,14725,1947,3455,1508,0.4,43,0
25,15496,508,3383,2875,3.2,43,0
0,0,0,0,0,2.1,45,0
1,4959,1746,2677,931,0.7,45,0
2,6002,189,1455,1266,3.6,45,0
3,5754,-639,419,1058,0.0,45,0
4,5649,-498,372,870,0.0,45,0
5,5406,-380,243,623,0.0,44,-1
6,5175,-361,176,537,0.0,44,0
7,4902,-311,100,411,0.0,44,0
8,4884,-170,200,370,0.0,43,-1
9,4791,-160,97,257,0.0,43,0
10,4750,-105,124,229,0.0,43,0
11,4684,-108,103,211,0.0,43,0
12,4656,-60,91,151,0.0,43,0
13,4669,-49,98,147,0.0,43,0
14,4667,-65,133,198,0.0,43,0
15,4817,-23,229,252,0.0,42,-1
16,4685,1,123,122,0.0,42,0
17,4685,1,123,122,0.0,42,0
18,4674,-50,136,186,0.0,42,0
19,4664,-40,95,135,0.0,42,0
20,4636,-61,53,114,0.0,42,0
21,4676,-5,108,113,0.0,42,0
22,4692,-55,121,176,0.0,42,0
23,4692,-55,121,176,0.0,42,0
24,4707,-19,102,121,0.0,42,0
25,4761,2,152,150,0.0,42,0
0,436,380,430,50,2.6,50,0
1,1730,1074,1566,492,14.0,50,0
2,26493,21516,24877,3361,7.2,50,0
3,38279,12126,15643,3517,7.7,50,0
4,37428,-619,5845,6464,5.7,50,0
5,32700,-4582,3565,8147,8.2,50,0
6,32601,-584,3077,3661,10.4,50,0
7,43363,9432,13479,4047,2.8,50,0
8,51041,7577,12245,4668,6.5,50,0
9,103500,50348,53477,3129,9.4,50,0
10,115456,12932,20598,7666,6.8,50,0
11,123126,6702,20908,14206,8.8,50,0
12,74364,-12657,9264,21921,6.3,50,0
13,104589,6474,22720,16246,3.7,50,0
14,104589,6474,22720,16246,11.6,50,0
15,111211,7709,24571,16862,9.0,50,0
16,99519,-11756,9147,20903,5.9,50,0
17,86484,-13238,3786,17024,4.4,50,0
18,78839,-7935,5380,13315,8.7,50,0
19,133143,38074,50289,12215,6.0,50,0
20,133143,38074,50289,12215,5.1,50,0
21,101246,-17028,8880,25908,12.2,50,0
22,201738,92165,111069,18904,9.0,50,0
0,0,0,0,0,3.2,45,0
1,882,525,707,182,2.1,45,0
2,1700,616,921,305,4.9,45,0
3,2434,486,967,481,5.2,45,0
4,12167,7664,8823,1159,3.5,45,0
5,18683,4595,7425,2830,3.2,45,0
6,24257,4111,6849,2738,4.4,45,0
7,23998,-197,2765,2962,0.7,45,0
8,22445,-1743,851,2594,3.0,45,0
9,24601,1535,2964,1429,1.3,45,0
10,27429,2695,4367,1672,4.0,45,0
11,28583,797,4047,3250,3.9,45,0
12,37930,-600,5856,6456,1.1,45,0
13,38133,1584,5803,4219,1.7,45,0
14,38133,1584,5803,4219,1.0,45,0
15,35842,-1079,3198,4277,2.0,45,0
16,39750,3522,5987,2465,1.8,45,0
17,35906,-3789,796,4585,1.4,45,0
18,34179,-1881,1538,3419,0.0,45,0
19,34113,-1270,2573,3843,9.7,45,0
20,34113,-1270,2573,3843,5.6,45,0
21,72995,37461,41297,3836,6.0,45,0
22,180656,99922,120292,20370,0.7,45,0
0,232,91,153,62,0.0,45,0
1,181,-47,20,67,0.0,45,0
2,183,-8,36,44,1.6,45,0
3,434,141,170,29,1.2,45,0
4,728,102,160,58,2.3,45,0
5,883,39,114,75,2.1,45,0
6,1112,101,193,92,1.0,45,0
7,1226,13,134,121,1.0,45,0
8,1692,336,439,103,2.7,45,0
9,2477,681,861,180,1.6,45,0
10,1979,-506,222,728,2.3,45,0
11,2970,17,406,389,1.9,45,0
12,3011,134,350,216,3.2,45,0
13,3011,134,350,216,2.8,45,0
14,3250,177,510,333,1.9,45,0
15,3946,567,831,264,1.8,45,0
16,3667,-306,203,509,2.1,45,0
17,3652,-106,223,329,3.8,45,0
18,7215,2073,2665,592,2.9,45,0
19,7215,2073,2665,592,4.5,45,0
20,9239,2925,3812,887,3.5,45,0
21,12135,2343,5040,2697,7.3,45,0
0,304,140,180,40,2.3,45,0
1,1024,484,647,163,1.7,45,0
2,1324,188,329,141,1.7,45,0
3,1586,150,331,181,3.5,45,0
4,1745,-4,233,237,2.1,45,0
5,1801,-35,126,161,3.2,45,0
6,1920,33,185,152,2.5,45,0
7,1985,-29,142,171,4.6,45,0
8,2372,264,374,110,2.3,45,0
9,4943,2294,2674,380,4.7,45,0
10,11187,5404,6783,1379,1.0,45,0
11,36211,7725,14791,7066,3.5,45,0
12,37469,6894,11420,4526,3.7,45,0
13,37469,6894,11420,4526,5.0,45,0
14,32626,-2568,2029,4597,1.3,45,0
15,33583,642,2887,2245,1.6,45,0
16,30642,-2926,429,3355,7.0,45,0
17,28889,-1895,976,2871,2.2,45,0
18,50677,12851,15990,3139,2.4,45,0
19,50677,12851,15990,3139,3.6,45,0
20,44557,2029,5651,3622,1.3,45,0
21,45278,209,5416,5207,5.1,45,0
0,57,20,38,18,0.0,45,0
1,79,17,41,24,0.0,45,0
2,54,-25,8,33,0.0,45,0
3,91,31,44,13,0.0,44,-1
4,56,-36,8,44,0.0,44,0
5,214,137,166,29,0.0,43,-1
6,188,-25,65,90,0.0,43,0
7,130,-56,5,61,0.0,43,0
8,136,2,32,30,0.0,43,0
9,195,53,82,29,0.0,43,0
10,223,-3,43,46,0.0,43,0
11,224,20,49,29,0.0,43,0
12,224,20,49,29,0.0,43,0
13,219,-4,45,49,0.0,43,0
14,203,-15,32,47,0.0,43,0
15,406,197,235,38,0.0,43,0
16,442,31,159,128,0.0,43,0
17,264,-181,49,230,0.0,43,0
18,264,-181,49,230,0.0,43,0
19,281,-7,49,56,0.0,43,0
20,301,-7,50,57,0.0,43,0
0,409,390,418,28,0.3,55,0
1,1504,903,1141,238,14.6,55,0
2,1504,903,1141,238,2.8,55,0
3,73622,68686,73806,5120,2.0,55,0
4,109950,34109,57584,23475,3.5,55,0
0,5862,0,0,0,0.0,45,0
1,5573,-1076,194,1270,0.0,45,0
2,8807,1148,2340,1192,0.0,44,-1
3,10299,310,1548,1238,0.0,44,0
4,10599,-446,1021,1467,0.0,44,0
5,10363,-572,539,1111,0.0,44,0
6,10515,-221,548,769,0.2,44,0
7,10601,-165,477,642,0.1,44,0
8,10782,-158,480,638,0.0,44,0
9,10753,-192,332,524,0.0,44,0
10,10184,-637,186,823,0.0,44,0
11,10006,-305,203,508,0.0,44,0
12,9972,-158,152,310,0.0,44,0
13,9952,-119,156,275,0.0,44,0
14,9967,-123,335,458,0.0,44,0
15,9874,-165,138,303,0.0,44,0
16,9803,-180,129,309,0.0,44,0
17,9769,-6,136,142,0.0,44,0
18,9769,-6,136,142,0.0,44,0
19,9392,-431,156,587,0.0,44,0
20,9091,-316,8,324,0.0,44,0
21,8813,-283,4,287,0.0,44,0
22,8534,-281,15,296,0.0,44,0
23,8323,-227,25,252,0.0,44,0
24,8185,-145,27,172,0.0,44,0
25,8080,-113,49,162,0.0,44,0
0,828679,0,0,0,1.2,55,0
1,937658,2625,51208,48583,3.2,55,0
2,875801,-79924,28607,108531,2.3,55,0
3,905317,-3696,43193,46889,2.4,55,0
4,915433,-7980,54588,62568,2.4,55,0
5,867560,-49202,12778,61980,3.6,55,0
6,876740,-3382,19439,22821,2.3,55,0
7,876833,-6023,16822,22845,1.4,55,0
8,855526,-22771,15175,37946,6.4,55,0
9,909847,31917,46847,14930,2.7,55,0
10,917353,5874,32914,27040,0.3,55,0
11,894033,-17168,12267,29435,3.6,55,0
12,871148,-22973,3438,26411,3.5,55,0
13,834702,-38498,2231,40729,1.8,55,0
14,818809,-18522,7590,26112,1.5,55,0
15,810195,-12624,7652,20276,0.4,55,0
16,799467,-13510,11506,25016,1.4,55,0
17,759761,590,24359,23769,2.5,55,0
18,759761,590,24359,23769,4.6,55,0
19,779485,18800,36558,17758,1.1,55,0
20,806746,24062,36109,12047,2.9,55,0
21,810224,2233,16820,14587,1.1,55,0
22,824952,10085,24742,14657,1.1,55,0
23,801819,-23303,11832,35135,2.6,55,0
24,806290,-2439,13786,16225,0.7,55,0
25,824323,14314,34364,20050,0.9,55,0
0,1369,0,0,0,0.0,45,0
1,5420,668,1032,364,0.0,45,0
2,7420,254,1284,1030,0.6,45,0
3,8961,412,1338,926,0.0,45,0
4,9447,-246,807,1053,0.0,45,0
5,9551,-216,592,808,2.4,45,0
6,11091,973,1485,512,1.7,45,0
7,12624,1066,1697,631,3.1,45,0
8,18174,4420,5791,1371,1.5,45,0
9,29093,9131,10594,1463,4.3,45,0
10,35614,5022,7401,2379,1.9,45,0
11,33383,-364,2494,2858,2.5,45,0
12,32924,-523,2037,2560,1.2,45,0
13,30679,-2403,1272,3675,0.0,45,0
14,27734,-3217,1438,4655,0.0,45,0
15,25396,-2571,670,3241,0.0,45,0
16,22900,-2653,649,3302,0.0,45,0
17,19992,-1054,650,1704,0.0,45,0
18,19992,-1054,650,1704,0.0,45,0
19,18752,-1428,355,1783,0.0,45,0
20,17987,-858,197,1055,0.0,45,0
21,17432,-618,153,771,0.0,45,0
22,16870,-675,145,820,0.0,45,0
23,16723,-281,562,843,0.0,45,0
24,16517,-349,313,662,0.0,45,0
25,16390,-244,516,760,0.0,45,0
0,7125,0,0,0,0.0,55,0
1,6808,-1029,202,1231,0.0,55,0
2,9235,553,1668,1115,1.3,55,0
3,10221,-24,1333,1357,1.9,55,0
4,12496,529,2139,1610,2.0,55,0
5,14530,1200,2308,1108,1.2,55,0
6,17366,1798,3150,1352,0.0,55,0
7,14796,-2445,197,2642,2.3,55,0
8,20304,3823,5030,1207,0.6,55,0
9,28991,6790,8426,1636,2.0,55,0
10,33152,3331,5750,2419,4.4,55,0
11,32917,284,2978,2694,1.1,55,0
12,26122,-6469,439,6908,0.0,55,0
13,25212,-1350,814,2164,1.0,55,0
14,27118,1063,2406,1343,1.8,55,0
15,30882,3190,4076,886,6.9,55,0
16,41036,8871,10875,2004,1.4,55,0
17,44029,2966,5096,2130,2.0,55,0
18,44029,2966,5096,2130,3.7,55,0
19,54502,9713,13104,3391,1.5,55,0
20,52916,-1449,4463,5912,3.2,55,0
21,57904,4225,6581,2356,2.6,55,0
22,61890,3056,6223,3167,2.2,55,0
23,67593,4188,9877,5689,2.0,55,0
24,76048,7208,12043,4835,3.1,55,0
25,101566,22536,29223,6687,0.4,55,0
0,12864,0,0,0,0.1,55,0
1,13995,-1284,1006,2290,0.2,55,0
2,12534,-2087,621,2708,0.0,55,0
3,11647,-1261,695,1956,0.0,54,-1
4,10556,-1356,305,1661,0.0,54,0
5,9789,-878,118,996,1.3,53,-1
6,9414,-502,118,620,4.4,53,0
7,9156,-320,185,505,2.8,53,0
8,8889,-352,192,544,3.5,53,0
9,9028,38,356,318,0.0,53,0
10,8745,-307,157,464,4.4,53,0
11,9096,216,510,294,7.9,53,0
12,9092,-39,249,288,0.0,53,0
13,8850,-257,118,375,6.6,53,0
14,8995,34,392,358,1.5,53,0
15,9241,191,432,241,0.0,53,0
16,9123,-153,309,462,5.5,53,0
17,10154,679,1065,386,5.5,53,0
18,10154,679,1065,386,7.8,53,0
19,10491,429,1113,684,2.4,53,0
20,10319,-212,399,611,6.1,53,0
21,10247,-139,405,544,0.4,53,0
22,9816,-460,154,614,3.5,52,-1
23,9421,-429,201,630,1.1,52,0
24,9300,-196,173,369,0.0,52,0
25,9431,54,518,464,6.0,52,0
0,13251,0,0,0,0.0,45,0
1,15294,-921,431,1352,0.0,45,0
2,15259,-1078,365,1443,0.0,45,0
3,15111,-758,250,1008,0.0,45,0
4,14971,-739,364,1103,0.0,45,0
5,14717,-535,179,714,0.0,45,0
6,14657,-265,237,502,0.0,44,-1
7,14545,-216,178,394,0.0,44,0
8,14522,-214,309,523,0.0,44,0
9,14387,-209,118,327,0.0,44,0
10,14267,-252,130,382,0.0,44,0
11,14110,-230,109,339,0.0,44,0
12,13991,-164,67,231,0.0,44,0
13,13887,-143,84,227,0.0,44,0
14,13806,-189,138,327,0.0,44,0
15,13673,-174,79,253,0.0,44,0
16,13511,-199,79,278,0.0,44,0
17,13187,-140,133,273,0.0,44,0
18,13187,-140,133,273,0.0,44,0
19,13163,-111,195,306,0.0,43,-1
20,13197,-8,164,172,0.0,43,0
21,13185,-57,61,118,0.0,43,0
22,13169,-73,101,174,0.0,43,0
23,13156,-81,227,308,0.0,43,0
24,13059,-162,99,261,0.0,43,0
25,12981,-137,140,277,0.0,43,0
0,1036141,0,0,0,11.8,100,0
1,1582960,226309,303351,77042,3.6,101,1
2,1345440,-247620,71441,319061,17.7,100,-1
3,1743133,296313,427289,130976,1.8,101,1
4,1748285,-30736,210612,241348,0.0,101,0
5,1240334,-489382,10116,499498,7.0,100,-1
6,1299954,17267,90813,73546,15.7,100,0
7,1519006,188734,214822,26088,8.6,100,0
8,1792751,240113,287883,47770,8.0,101,1
9,2181811,363213,393733,30520,9.3,102,1
10,2328122,136442,206814,70372,5.8,103,1
11,2237147,-67357,70284,137641,13.8,103,0
12,2248063,1519,82832,81313,7.1,103,0
13,2065491,-180913,39140,220053,17.6,102,-1
14,1975640,-100730,81523,182253,3.6,101,-1
15,2155237,154629,197083,42454,0.1,101,0
16,2242578,79570,150765,71195,5.0,102,1
17,2377973,293110,371825,78715,7.5,101,-1
18,2377973,293110,371825,78715,3.4,101,0
19,1448576,-822869,92493,915362,0.0,101,0
20,1159635,-294001,6709,300710,0.0,100,-1
21,1060762,-102372,9002,111374,0.0,100,0
22,1107826,41344,86452,45108,1.1,100,0
23,1186386,70815,122600,51785,11.2,100,0
24,1410017,212731,238569,25838,4.4,101,1
25,1677796,247585,292684,45099,2.1,102,1
0,4535,0,0,0,7.8,55,0
1,21300,8800,12889,4089,10.8,55,0
2,51928,25188,37903,12715,2.0,55,0
3,49736,-1779,13954,15733,0.0,55,0
4,37182,-12764,1472,14236,0.2,55,0
5,33675,-4759,1330,6089,0.9,55,0
6,31279,-2931,1008,3939,1.4,55,0
7,28488,-2977,993,3970,2.1,55,0
8,29189,174,3087,2913,2.8,55,0
9,30747,1083,3645,2562,3.6,55,0
10,28381,-2353,1462,3815,0.0,55,0
11,25823,-2828,559,3387,0.0,55,0
12,23606,-2262,245,2507,0.0,54,-1
13,21309,-2387,105,2492,0.2,54,0
14,19673,-1687,216,1903,0.0,53,-1
15,18792,-987,168,1155,3.9,53,0
16,18074,-763,223,986,0.0,53,0
17,15515,-1198,17,1215,0.0,52,-1
18,15515,-1198,17,1215,0.0,52,0
19,14334,-1283,21,1304,0.0,52,0
20,13793,-556,14,570,0.0,52,0
21,13436,-351,24,375,0.0,52,0
22,13090,-361,15,376,0.0,52,0
23,12735,-355,18,373,0.0,52,0
24,12561,-187,11,198,0.0,52,0
25,12385,-174,17,191,0.0,52,0
0,8705,0,0,0,0.0,60,0
1,8008,-1878,357,2235,0.0,60,0
2,7028,-1470,386,1856,0.0,60,0
3,6413,-899,291,1190,0.0,59,-1
4,6248,-382,392,774,0.0,59,0
5,6057,-284,219,503,0.0,59,0
6,5809,-307,165,472,0.0,59,0
7,5644,-202,128,330,0.0,59,0
8,5597,-96,289,385,0.0,59,0
9,5683,22,243,221,0.0,59,0
10,8662,2485,3285,800,0.0,59,0
11,7072,-1269,300,1569,0.0,59,0
12,6534,-580,69,649,0.0,59,0
13,6265,-304,60,364,0.0,59,0
14,5948,-331,121,452,0.0,59,0
15,5796,-177,52,229,0.0,59,0
16,5699,-116,71,187,0.0,59,0
17,5763,10,115,105,0.0,59,0
18,5763,10,115,105,0.3,59,0
19,8369,1997,2674,677,0.0,59,0
20,9369,784,1463,679,2.0,59,0
21,14340,4598,5484,886,4.8,59,0
22,20386,5363,6747,1384,1.8,59,0
23,26879,5712,8895,3183,2.8,59,0
24,42719,15036,19275,4239,7.9,59,0
25,100235,53178,62545,9367,1.0,59,0
0,86735,0,0,0,0.0,40,0
1,98950,-4290,8453,12743,0.0,40,0
2,101775,-3002,10762,13764,1.3,40,0
3,110032,4021,14441,10420,1.1,40,0
4,93264,-14928,4563,19491,0.0,40,0
5,83238,-10903,652,11555,0.0,40,0
6,76932,-6910,342,7252,0.0,40,0
7,71298,-5631,248,5879,0.0,40,0
8,66461,-4875,809,5684,0.0,39,-1
9,64475,-2386,474,2860,0.0,39,0
10,62070,-2440,444,2884,0.0,39,0
11,60836,-1424,460,1884,0.0,39,0
12,60358,-569,604,1173,0.0,39,0
13,60004,-454,707,1161,0.3,39,0
14,73707,11035,12932,1897,0.0,39,0
15,73634,956,3259,2303,2.0,39,0
16,76412,2381,5354,2973,0.0,39,0
17,79699,287,3849,3562,0.0,39,0
18,79699,287,3849,3562,0.0,39,0
19,75282,-2445,2370,4815,0.0,39,0
20,73474,-1993,948,2941,0.0,39,0
21,71969,-1711,776,2487,0.4,39,0
22,70795,-1423,929,2352,0.0,39,0
23,69913,-1093,1665,2758,2.2,39,0
24,78112,7502,11413,3911,0.5,39,0
25,80876,1753,7257,5504,2.7,39,0
0,127919,0,0,0,2.9,65,0
1,133691,-9707,9988,19695,6.5,65,0
2,113040,-24255,4668,28923,6.5,64,-1
3,143902,20467,32544,12077,3.0,64,0
4,136417,-9923,11472,21395,3.6,64,0
5,124857,-12899,4030,16929,1.8,64,0
6,119451,-7516,3939,11455,10.8,64,0
7,150218,23544,30633,7089,3.0,64,0
8,181834,23989,38899,14910,3.8,64,0
9,244716,55504,69267,13763,6.2,64,0
10,228313,-12651,16622,29273,3.7,64,0
11,213506,-16408,10572,26980,2.0,64,0
12,199780,-14086,7365,21451,2.6,64,0
13,182195,-18417,4010,22427,1.5,64,0
14,171276,-11906,6347,18253,3.9,64,0
15,169625,-3058,5936,8994,1.8,64,0
16,163768,-6699,5846,12545,5.7,64,0
17,167702,5800,12751,6951,8.8,64,0
18,167702,5800,12751,6951,3.6,64,0
19,189340,20927,31173,10246,10.2,64,0
20,233587,41278,49908,8630,4.6,64,0
21,241935,7078,22239,15161,3.6,64,0
22,229661,-14019,10740,24759,4.5,64,0
23,208869,-21004,9034,30038,2.3,64,0
24,197139,-14230,5236,19466,6.3,64,0
25,210061,9874,24639,14765,6.8,64,0
0,215629,0,0,0,2.7,65,0
1,198539,-27557,12465,40022,3.8,65,0
2,146274,-54236,4840,59076,0.0,64,-1
3,118569,-31074,3452,34526,0.7,63,-1
4,98585,-21545,2149,23694,10.2,63,0
5,87092,-12403,1246,13649,0.0,62,-1
6,77770,-10041,817,10858,0.0,62,0
7,69988,-8029,661,8690,0.0,61,-1
8,63592,-6671,725,7396,0.0,61,0
9,61169,-2929,889,3818,0.0,61,0
10,58130,-3179,588,3767,11.7,60,-1
11,65561,6227,8042,1815,6.6,60,0
12,64628,-520,2390,2910,5.1,60,0
13,62150,-2606,1133,3739,0.0,60,0
14,59059,-3309,1025,4334,2.5,60,0
15,59306,-160,1775,1935,6.7,60,0
16,58460,-978,1386,2364,0.0,60,0
17,55878,-306,1096,1402,2.4,60,0
18,55878,-306,1096,1402,0.4,60,0
19,55438,-599,1510,2109,3.2,60,0
20,56128,550,2117,1567,10.8,60,0
21,56817,551,1971,1420,0.8,60,0
22,55012,-1933,427,2360,2.9,60,0
23,52823,-2248,228,2476,0.0,60,0
24,50269,-2618,28,2646,0.0,60,0
25,48397,-1866,43,1909,0.0,60,0
0,81625,0,0,0,1.5,70,0
1,107645,4726,20171,15445,1.1,70,0
2,99505,-14665,9206,23871,4.3,70,0
3,259670,132793,154298,21505,0.0,70,0
4,181628,-70580,20902,91482,3.5,70,0
5,170479,-18430,13457,31887,2.0,70,0
6,173122,-1894,16541,18435,2.5,70,0
7,170993,-4305,14465,18770,6.3,70,0
8,164679,-8804,13924,22728,9.7,70,0
9,214039,42924,54121,11197,4.2,70,0
10,205527,-6665,16465,23130,8.5,70,0
11,204432,-2580,20371,22951,16.8,70,0
12,371978,160865,170121,9256,9.1,71,1
13,390621,19485,55996,36511,10.1,71,0
14,432220,34910,77316,42406,6.9,71,0
15,544751,105517,128815,23298,0.0,72,1
16,404886,-135641,10223,145864,9.5,72,0
17,430945,48095,79523,31428,9.4,71,-1
18,430945,48095,79523,31428,7.4,71,0
19,952450,514549,553340,38791,9.2,72,1
20,1052669,101184,164402,63218,6.5,72,0
21,1142081,83839,130100,46261,11.3,73,1
22,1346312,192545,220417,27872,10.2,74,1
23,1205419,-131568,82701,214269,8.8,74,0
24,1295526,65076,119305,54229,8.9,73,-1
25,882507,-397634,67434,465068,0.0,73,0
0,41594,0,0,0,0.0,60,0
1,37056,-9602,2581,12183,0.0,59,-1
2,28947,-9684,1230,10914,0.0,58,-1
3,26469,-3840,1589,5429,4.1,58,0
4,24537,-2735,1180,3915,3.5,57,-1
5,25251,-23,2223,2246,0.0,57,0
6,23761,-1799,773,2572,0.0,57,0
7,23014,-980,734,1714,0.0,57,0
8,22512,-880,805,1685,0.0,56,-1
9,22054,-658,342,1000,5.6,56,0
10,21831,-382,538,920,2.3,56,0
11,21647,-323,487,810,0.0,56,0
12,21367,-363,246,609,2.2,56,0
13,21143,-287,210,497,0.3,56,0
14,21030,-270,468,738,0.0,56,0
15,21222,59,553,494,4.5,56,0
16,20870,-399,398,797,0.0,56,0
17,21951,741,1409,668,0.0,56,0
18,21951,741,1409,668,0.3,56,0
19,24899,2899,5101,2202,0.0,56,0
20,25555,581,2576,1995,0.0,56,0
21,24451,-1201,1124,2325,8.5,56,0
22,27065,2198,3654,1456,5.2,56,0
23,26124,-1039,1869,2908,0.0,56,0
24,25221,-1141,1021,2162,0.0,56,0
25,24687,-693,1087,1780,3.8,56,0
0,5293,0,0,0,0.0,50,0
1,5507,-767,306,1073,0.0,50,0
2,5181,-719,316,1035,0.0,49,-1
3,5016,-365,362,727,0.1,49,0
4,4745,-434,174,608,0.4,49,0
5,4617,-242,118,360,0.0,49,0
6,4722,4,292,288,0.0,48,-1
7,4769,-34,314,348,0.0,48,0
8,4624,-202,185,387,0.0,48,0
9,4582,-112,100,212,0.0,48,0
10,4464,-157,59,216,0.0,48,0
11,4363,-130,37,167,0.0,48,0
12,4321,-78,45,123,0.0,48,0
13,4311,-46,71,117,0.0,47,-1
14,4322,-43,138,181,0.0,47,0
15,4274,-60,39,99,0.5,47,0
16,4274,-38,80,118,0.0,47,0
17,4212,-32,51,83,0.0,47,0
18,4212,-32,51,83,0.0,47,0
19,4154,-70,66,136,0.0,47,0
20,4089,-74,29,103,0.0,47,0
21,4060,-43,32,75,0.4,47,0
22,4049,-49,36,85,2.7,47,0
23,4078,5,87,82,0.1,47,0
24,4032,-63,40,103,0.0,47,0
25,4034,-23,73,96,0.0,47,0
0,251556,0,0,0,10.2,70,0
1,237923,-25796,22609,48405,18.3,70,0
2,252528,3993,58692,54699,2.8,70,0
3,522260,242823,282418,39595,1.9,71,1
4,450483,-64924,49452,114376,3.6,71,0
5,357564,-93404,9915,103319,0.4,70,-1
6,317052,-45380,11172,56552,8.0,70,0
7,318030,-3429,28282,31711,1.8,69,-1
8,277153,-39257,14813,54070,7.4,69,0
9,318251,32583,54466,21883,6.7,69,0
10,317335,-907,28082,28989,0.0,69,0
11,277216,-37959,14009,51968,2.7,69,0
12,241949,-35354,7066,42420,1.5,68,-1
13,216861,-26143,3335,29478,7.1,68,0
14,202221,-15139,5138,20277,6.4,67,-1
15,238068,32433,38694,6261,7.1,67,0
16,339816,97870,113702,15832,4.3,67,0
17,351686,30844,60050,29206,15.5,68,1
18,351686,30844,60050,29206,5.2,68,0
19,444600,96875,132322,35447,13.5,68,0
20,534595,88170,113984,25814,9.6,68,0
21,673608,134182,148776,14594,5.2,69,1
22,656477,-18257,45490,63747,4.6,69,0
23,550367,-102614,30568,133182,11.3,69,0
24,679554,112614,143772,31158,16.5,68,-1
25,1818990,1089298,1114343,25045,1.1,69,1
0,126755,0,0,0,2.8,50,0
1,143142,-6431,12437,18868,2.1,50,0
2,102875,-41836,4583,46419,0.0,50,0
3,70629,-34574,350,34924,0.0,49,-1
4,56925,-15124,230,15354,0.0,49,0
5,51222,-6343,118,6461,0.0,49,0
6,47801,-3706,120,3826,0.0,48,-1
7,45349,-2584,106,2690,0.0,48,0
8,43072,-2339,111,2450,0.0,48,0
9,42228,-958,75,1033,0.0,48,0
10,42017,-376,494,870,1.9,48,0
11,42972,577,1162,585,1.5,48,0
12,43938,763,1243,480,3.4,48,0
13,44418,333,940,607,3.5,48,0
14,46950,1857,3038,1181,1.9,48,0
15,47766,623,1563,940,0.0,48,0
16,47990,-70,1411,1481,2.6,48,0
17,49729,443,1437,994,1.7,48,0
18,49729,443,1437,994,5.0,48,0
19,54622,4008,6008,2000,1.2,48,0
20,50794,-3719,906,4625,0.0,48,0
21,47508,-3338,62,3400,0.0,48,0
22,45682,-1893,88,1981,0.0,48,0
23,45075,-782,374,1156,8.3,48,0
24,47422,1733,2341,608,1.2,48,0
25,49935,1925,3268,1343,4.6,48,0
0,771267,0,0,0,2.3,55,0
1,861165,-16165,41879,58044,8.9,55,0
2,787846,-95807,30897,126704,1.8,55,0
3,746576,-64334,19529,83863,2.2,55,0
4,595195,-153786,8685,162471,0.0,55,0
5,408583,-190759,254,191013,0.0,54,-1
6,325591,-91782,123,91905,0.0,54,0
7,280914,-46336,77,46413,0.0,53,-1
8,250572,-30496,118,30614,0.0,53,0
9,239597,-12347,73,12420,0.0,53,0
10,231331,-8530,662,9192,0.0,53,0
11,225772,-5957,107,6064,0.0,53,0
12,222239,-3697,53,3750,0.0,53,0
13,217876,-4435,17,4452,0.0,53,0
14,212200,-5606,85,5691,0.0,53,0
15,210715,-1732,150,1882,0.0,53,0
16,211257,149,1533,1384,0.2,53,0
17,211522,340,1406,1066,0.8,53,0
18,211522,340,1406,1066,0.0,53,0
19,210721,-1042,1414,2456,0.7,53,0
20,211003,-23,1232,1255,2.0,53,0
21,211716,430,1937,1507,3.6,53,0
22,214289,1851,3248,1397,3.0,53,0
23,217553,2449,4709,2260,2.2,53,0
24,228572,9874,12965,3091,2.7,53,0
25,252593,21654,27638,5984,2.6,53,0
0,681843,0,0,0,3.5,45,0
1,1081585,271058,322380,51322,9.2,46,1
2,1435891,300017,416733,116716,2.8,47,1
3,1636952,166998,238128,71130,1.4,47,0
4,1627600,-11258,122485,133743,3.2,47,0
5,1573115,-56633,38343,94976,0.6,48,1
6,1613153,24390,61208,36818,2.2,48,0
7,1611472,-1602,42512,44114,2.4,48,0
8,1646134,35767,83074,47307,0.7,48,0
9,1786329,108191,140130,31939,2.4,48,0
10,1810163,25220,69953,44733,4.2,49,1
11,1768433,-36824,25714,62538,11.1,49,0
12,1782038,10356,50723,40367,4.1,49,0
13,1741436,-43400,31033,74433,5.0,49,0
14,1883088,129766,166838,37072,4.7,49,0
15,2026134,134754,167910,33156,7.4,50,1
16,2093176,63483,119995,56512,1.8,50,0
17,1930626,19098,101388,82290,3.6,50,0
18,1930626,19098,101388,82290,2.2,50,0
19,2051017,115768,162911,47143,7.1,50,0
20,2106960,54033,98085,44052,4.4,50,0
21,2147411,37190,75870,38680,9.7,51,1
22,2351742,192532,215759,23227,2.3,52,1
23,1745770,-578327,113681,692008,0.0,51,-1
24,1124506,-647193,2930,650123,0.0,50,-1
25,790257,-331179,1426,332605,0.0,50,0
0,27278,0,0,0,0.0,45,0
1,21987,-7407,644,8051,0.0,44,-1
2,18678,-4224,896,5120,0.0,44,0
3,16934,-2309,728,3037,0.0,43,-1
4,16240,-1285,1321,2606,0.0,43,0
5,15612,-881,684,1565,0.0,43,0
6,15163,-671,469,1140,3.5,43,0
7,15430,-18,826,844,0.0,43,0
8,15307,-303,757,1060,0.0,43,0
9,15256,-212,496,708,0.0,43,0
10,15049,-351,441,792,0.0,43,0
11,14596,-488,262,750,0.0,43,0
12,14341,-342,229,571,0.0,42,-1
13,14165,-245,262,507,0.0,42,0
14,14132,-196,525,721,0.0,42,0
15,13976,-220,252,472,3.1,42,0
16,14255,176,686,510,0.0,42,0
17,14200,-74,352,426,0.0,42,0
18,14200,-74,352,426,0.0,42,0
19,13904,-369,280,649,0.0,42,0
20,13691,-251,128,379,0.0,42,0
21,13533,-199,101,300,0.0,42,0
22,13387,-213,137,350,0.0,42,0
23,13367,-93,311,404,0.0,42,0
24,13327,-125,193,318,4.6,42,0
25,22257,8292,10080,1788,0.5,42,0
0,67356,0,0,0,8.4,55,0
1,313021,129938,156832,26894,6.2,55,0
2,710062,312939,408415,95476,4.4,56,1
3,1195613,407839,442592,34753,4.5,57,1
4,1508324,260465,342681,82216,4.4,58,1
5,1500321,11055,115705,104650,3.1,58,0
6,1260260,-244091,90284,334375,0.0,58,0
7,781688,-474344,1705,476049,0.0,57,-1
8,664602,-129575,15457,145032,0.0,57,0
9,636726,-35497,20647,56144,0.0,57,0
10,537118,-93861,2750,96611,0.0,57,0
11,449658,-96423,235,96658,0.0,57,0
12,413013,-38303,180,38483,0.0,57,0
13,389649,-24304,480,24784,1.1,57,0
14,387235,-3106,11548,14654,1.6,57,0
15,396269,7681,14573,6892,0.0,57,0
16,391091,-5544,9747,15291,5.4,57,0
17,375478,-326,8684,9010,1.4,57,0
18,375478,-326,8684,9010,2.7,57,0
19,382158,6439,16033,9594,4.5,57,0
20,390872,8092,14906,6814,0.3,57,0
21,364906,-25276,3209,28485,0.0,57,0
22,336701,-28239,172,28411,0.0,57,0
23,312607,-23833,107,23940,0.0,57,0
24,306135,-7422,899,8321,3.8,57,0
25,324627,16675,22672,5997,1.4,57,0
0,17814,0,0,0,1.3,45,0
1,108906,50657,69301,18644,1.6,45,0
2,124069,11683,32855,21172,5.3,45,0
3,236816,92477,117672,25195,2.4,45,0
4,218984,-11967,24076,36043,1.2,45,0
5,227833,3074,24367,21293,1.2,45,0
6,230367,365,15585,15220,0.7,45,0
7,225689,-5414,12676,18090,1.7,45,0
8,225328,-1590,18897,20487,0.6,45,0
9,237876,8921,21537,12616,0.7,45,0
10,231557,-6276,12478,18754,1.5,45,0
11,232444,-868,11897,12765,0.2,45,0
12,223126,-9004,3994,12998,0.4,45,0
13,212438,-11492,2557,14049,0.0,45,0
14,205523,-7784,7310,15094,0.0,45,0
15,194420,-11509,1843,13352,1.3,45,0
16,184871,-10226,3120,13346,0.0,45,0
17,165277,-6350,9546,15896,0.0,44,-1
18,165277,-6350,9546,15896,0.0,44,0
19,152063,-13669,4081,17750,0.7,44,0
20,137634,-14645,1239,15884,2.9,44,0
21,133097,-5169,2864,8033,0.4,43,-1
22,126993,-6480,1788,8268,0.0,43,0
23,120750,-6350,2073,8423,0.0,43,0
24,117469,-3986,1327,5313,0.1,43,0
25,133353,10658,17910,7252,0.0,42,-1
0,2009,1454,2174,720,0.0,60,0
1,3353,917,1792,875,1.0,60,0
2,3756,-55,1136,1191,0.0,60,0
3,3301,-593,300,893,3.5,60,0
4,4893,1213,1718,505,4.4,59,-1
5,7376,2117,2916,799,0.0,59,0
6,7305,-256,1446,1702,1.8,59,0
7,7327,-190,980,1170,4.6,59,0
8,6565,-860,497,1357,0.0,59,0
9,6091,-647,416,1063,0.0,59,0
10,5746,-443,306,749,3.7,59,0
11,5505,-331,222,553,0.0,59,0
12,5123,-513,184,697,0.0,58,-1
13,4681,-467,20,487,0.0,58,0
14,4288,-406,16,422,0.0,58,0
15,3988,-141,24,165,0.0,57,-1
16,3988,-141,24,165,0.0,57,0
17,4011,-99,85,184,4.9,57,0
18,3977,-62,52,114,0.2,57,0
19,3977,-40,46,86,0.0,57,0
20,3969,-77,33,110,0.0,57,0
21,3947,-99,41,140,0.0,57,0
22,3971,-51,46,97,0.0,57,0
23,4050,-15,93,108,0.8,57,0
0,0,0,0,0,0.0,50,0
1,1119,724,891,167,2.7,50,0
2,2589,1159,1454,295,1.5,50,0
3,6704,3443,3813,370,2.3,50,0
4,10421,3113,3948,835,3.0,50,0
5,17187,5930,8422,2492,2.4,50,0
6,45429,24187,26023,1836,2.8,50,0
7,52776,7268,11448,4180,3.4,50,0
8,49983,-985,4333,5318,3.3,50,0
9,47953,-2088,2294,4382,6.3,50,0
10,43769,-4491,1724,6215,3.4,50,0
11,56771,10935,14397,3462,0.9,50,0
12,68393,10734,13988,3254,0.0,50,0
13,54146,-13615,2292,15907,3.1,50,0
14,54972,2815,6572,3757,1.5,50,0
15,54972,2815,6572,3757,2.1,50,0
16,57666,2695,8619,5924,3.3,50,0
17,60811,2540,5688,3148,2.4,50,0
18,57360,-3705,3439,7144,0.0,50,0
19,38808,-18481,296,18777,0.0,50,0
20,29100,-9744,214,9958,0.0,50,0
21,26015,-3460,159,3619,0.0,50,0
22,23292,-2743,107,2850,0.0,50,0
0,0,0,0,0,0.0,40,0
1,125,44,49,5,0.0,40,0
2,473,149,218,69,0.0,40,0
3,601,-13,110,123,0.0,40,0
4,791,38,149,111,0.0,40,0
0,0,0,0,0,0.0,45,0
1,15,8,8,0,0.0,45,0
2,76,39,65,26,0.0,45,0
3,76,-14,15,29,0.0,45,0
4,163,33,72,39,0.0,44,-1
0,0,0,0,0,0.0,45,0
0,111474,0,0,0,1.3,60,0
1,112167,-8951,11349,20300,0.0,60,0
2,52255,-59014,745,59759,0.0,59,-1
3,34028,-20148,130,20278,0.0,58,-1
4,28320,-6302,491,6793,2.6,58,0
5,27614,-1290,1039,2329,2.2,58,0
6,26629,-1391,957,2348,1.8,58,0
7,25979,-889,871,1760,0.0,58,0
8,23730,-2449,506,2955,0.0,57,-1
9,21528,-2220,26,2246,0.0,57,0
10,19840,-1733,61,1794,0.0,57,0
11,19533,-443,341,784,0.0,57,0
12,19602,-20,383,403,5.7,57,0
13,20962,1202,1561,359,0.0,57,0
14,20959,-185,906,1091,1.6,57,0
15,20845,-213,408,621,0.5,57,0
16,20660,-295,565,860,6.1,57,0
17,20323,-119,366,485,0.6,57,0
18,20139,-339,290,629,0.0,57,0
19,19830,-359,89,448,0.0,57,0
20,19665,-219,150,369,0.4,57,0
21,19547,-204,166,370,0.0,57,0
22,19047,-524,128,652,0.0,57,0
23,19543,358,823,465,0.1,57,0
24,19543,358,823,465,0.3,57,0
0,149614,0,0,0,0.0,45,0
1,142124,-19435,5482,24917,0.0,45,0
2,122364,-23005,2911,25916,0.0,44,-1
3,109127,-15028,1764,16792,0.0,44,0
4,92954,-16451,646,17097,0.0,44,0
5,88664,-5619,1672,7291,0.0,43,-1
6,86599,-2836,1421,4257,0.0,43,0
7,84915,-2105,1337,3442,0.0,43,0
8,82414,-2837,1313,4150,0.0,43,0
9,80824,-1845,836,2681,0.0,43,0
10,78579,-2390,1000,3390,0.0,43,0
11,77323,-1626,770,2396,0.0,43,0
12,76005,-1430,262,1692,0.0,43,0
13,74588,-1505,261,1766,0.0,43,0
14,73886,-970,1076,2046,0.0,42,-1
15,72986,-1004,656,1660,0.0,42,0
16,72085,-1038,924,1962,0.0,42,0
17,69106,-1287,560,1847,0.8,42,0
18,70711,973,3117,2144,0.0,42,0
19,70089,-653,596,1249,0.0,42,0
20,69763,-452,545,997,0.0,42,0
21,69485,-432,842,1274,0.0,42,0
22,68560,-1016,566,1582,0.0,42,0
23,67684,-1067,337,1404,0.0,42,0
24,67684,-1067,337,1404,0.0,42,0
0,51620,0,0,0,0.0,45,0
1,40527,-12336,844,13180,1.4,45,0
2,44778,1272,9477,8205,3.3,44,-1
3,53096,5970,11426,5456,3.9,44,0
4,57184,2701,14449,11748,0.0,44,0
5,50252,-6553,1284,7837,0.0,44,0
6,45776,-5108,547,5655,2.0,44,0
7,44162,-1880,861,2741,2.2,44,0
8,41428,-2826,487,3313,2.3,44,0
9,41229,-572,711,1283,1.5,44,0
10,41215,-191,1077,1268,2.8,44,0
11,42730,924,2272,1348,3.0,44,0
12,43279,445,1894,1449,3.9,44,0
13,42277,-990,844,1834,8.2,44,0
14,37861,-4398,1293,5691,0.0,44,0
15,33690,-4272,38,4310,0.0,44,0
16,29956,-3813,173,3986,0.0,43,-1
17,29510,783,2286,1503,5.6,43,0
18,29923,326,1983,1657,2.3,43,0
19,29747,-231,931,1162,10.3,43,0
20,30148,288,1031,743,2.3,43,0
21,30416,103,1075,972,3.0,43,0
22,31709,1055,2254,1199,2.9,43,0
23,34150,2299,3568,1269,11.9,43,0
24,34150,2299,3568,1269,4.7,43,0
0,237865,0,0,0,4.0,45,0
1,284510,21987,50630,28643,2.0,45,0
2,260991,-26160,22371,48531,4.6,45,0
3,262791,-3015,18146,21161,7.0,45,0
4,299049,27121,61956,34835,9.3,45,0
5,301258,2262,23420,21158,3.3,45,0
6,324419,18994,27978,8984,5.0,45,0
7,318044,-5960,11063,17023,3.7,45,0
8,290303,-26515,5262,31777,2.1,45,0
9,287669,-5593,6079,11672,7.4,45,0
10,287339,-377,9375,9752,1.5,45,0
11,297337,6435,16635,10200,6.7,45,0
12,298833,779,12232,11453,5.4,45,0
13,287262,-11454,6132,17586,5.1,45,0
14,280490,-7903,12657,20560,3.8,45,0
15,279121,-2433,10506,12939,3.4,45,0
16,272375,-6934,10332,17266,2.1,45,0
17,231791,-16846,5901,22747,5.4,45,0
18,221228,-15355,4163,19518,4.3,45,0
19,208538,-12904,1930,14834,3.8,45,0
20,202908,-6069,2236,8305,8.2,45,0
21,196257,-7050,3225,10275,6.7,44,-1
22,191812,-4285,5238,9523,1.8,44,0
23,200186,7091,14678,7587,5.6,44,0
24,200186,7091,14678,7587,2.1,44,0
0,34553,0,0,0,8.3,55,0
1,245552,126282,158316,32034,9.3,55,0
2,502564,215176,298394,83218,6.5,56,1
3,582964,72271,128852,56581,4.1,56,0
4,551537,-34765,59033,93798,2.9,56,0
5,504323,-50949,17761,68710,10.3,56,0
6,510123,-1219,29676,30895,2.6,56,0
7,465851,-43348,12732,56080,8.6,56,0
8,446011,-22439,26418,48857,5.6,56,0
9,446898,-3864,28735,32599,6.2,55,-1
10,413104,-31870,17656,49526,6.0,55,0
11,413610,-5836,26559,32395,7.3,55,0
12,503803,85582,96744,11162,9.4,55,0
13,518880,16104,41870,25766,3.5,55,0
14,547418,24925,62189,37264,1.7,55,0
15,540737,-7693,27354,35047,6.5,55,0
16,455630,-83860,5813,89673,6.9,55,0
17,359044,-39125,10086,49211,1.2,55,0
18,333115,-33343,5411,38754,2.5,54,-1
19,288276,-44950,452,45402,1.9,54,0
20,270472,-18413,1491,19904,2.7,53,-1
21,255357,-15544,1359,16903,4.4,53,0
22,239710,-15089,2349,17438,0.2,53,0
23,236523,-4590,4885,9475,1.0,52,-1
24,236523,-4590,4885,9475,0.3,52,0
0,2009,0,0,0,0.0,50,0
1,1293,-721,33,754,0.0,50,0
2,978,-360,37,397,0.0,49,-1
3,836,-151,8,159,0.0,49,0
4,732,-107,15,122,0.0,49,0
5,695,-44,26,70,0.0,49,0
6,649,-48,5,53,0.0,48,-1
7,640,-20,14,34,0.0,48,0
8,617,-15,36,51,0.0,48,0
9,602,-16,16,32,0.0,48,0
10,642,30,63,33,0.0,48,0
11,597,-43,28,71,0.0,48,0
12,579,-15,11,26,0.0,48,0
13,580,-3,8,11,0.0,48,0
14,582,0,13,13,0.0,48,0
15,582,-2,8,10,0.0,48,0
16,581,-3,7,10,0.0,48,0
17,569,-4,6,10,0.0,48,0
18,580,8,23,15,0.0,48,0
19,576,-4,11,15,0.0,48,0
20,569,-7,5,12,0.0,48,0
21,574,5,18,13,0.0,48,0
22,580,3,19,16,0.0,48,0
23,587,7,20,13,0.0,48,0
24,587,7,20,13,0.0,48,0
0,256415,0,0,0,2.7,45,0
1,358887,58951,92240,33289,2.9,45,0
2,336050,-24854,32459,57313,6.8,45,0
3,349548,6112,37346,31234,6.8,45,0
4,409451,50072,92669,42597,2.3,45,0
5,406653,-2536,25860,28396,5.1,45,0
6,432496,20364,31896,11532,5.3,45,0
7,459111,22375,35971,13596,1.7,45,0
8,435682,-20364,15343,35707,6.2,45,0
9,442509,2568,17718,15150,5.7,45,0
10,502752,55225,66891,11666,1.6,45,0
11,553806,45533,58754,13221,3.2,46,1
12,564237,10561,29566,19005,11.1,46,0
13,615705,48925,61216,12291,8.1,46,0
14,860685,230950,243808,12858,1.6,47,1
15,1008716,146112,160150,14038,7.3,47,0
16,1201195,191087,223911,32824,2.6,48,1
17,1135672,-24687,93339,118026,1.3,48,0
18,1114103,-54777,48828,103605,4.1,48,0
19,1024176,-90240,14265,104505,6.0,48,0
20,1093005,63157,80365,17208,5.7,48,0
21,1136910,40797,71775,30978,7.7,48,0
22,1286800,146898,182612,35714,3.0,49,1
23,1752844,451580,485670,34090,1.0,50,1
24,1752844,451580,485670,34090,7.8,50,0
0,44238,0,0,0,0.0,45,0
1,40659,-7209,2193,9402,2.6,45,0
2,36694,-5507,2516,8023,0.1,44,-1
3,33241,-3981,1210,5191,0.8,44,0
4,31424,-2453,1857,4310,0.0,44,0
5,29546,-2104,812,2916,6.4,44,0
6,34846,4064,5539,1475,2.3,44,0
7,33575,-1068,1358,2426,3.5,44,0
8,30341,-3117,701,3818,5.7,44,0
9,34851,3409,4772,1363,4.1,44,0
10,45772,9594,11678,2084,1.0,44,0
11,68415,21118,24654,3536,2.4,44,0
12,71532,3682,9830,6148,11.1,44,0
13,106920,32787,36433,3646,4.1,44,0
14,139211,30244,40498,10254,2.9,44,0
15,162304,22629,29170,6541,6.5,44,0
16,231544,67731,82017,14286,1.9,45,1
17,237067,3216,34485,31269,1.9,45,0
18,230595,-11297,19949,31246,0.4,45,0
19,201921,-28514,4380,32894,1.8,45,0
20,193483,-9152,4340,13492,1.5,45,0
21,184780,-9268,6638,15906,5.9,44,-1
22,182746,-1933,13695,15628,1.5,44,0
23,194888,10742,23611,12869,1.3,44,0
24,194888,10742,23611,12869,1.7,44,0
0,226666,0,0,0,6.8,55,0
1,752960,364945,429720,64775,8.3,56,1
2,1408294,542839,668971,126132,9.1,57,1
3,1753114,307756,413623,105867,8.0,58,1
4,1833951,58061,255988,197927,3.1,58,0
5,1771278,-71449,108971,180420,23.7,58,0
6,2324156,496839,520755,23916,7.9,59,1
7,2453122,130325,221902,91577,6.2,60,1
8,2670112,189837,297123,107286,7.8,61,1
9,2680255,2181,114636,112455,9.4,61,0
10,2621988,-55858,128708,184566,7.2,61,0
11,2950528,279128,320628,41500,3.4,62,1
12,3114787,156769,191883,35114,13.3,63,1
13,3209689,95233,152936,57703,3.3,63,0
14,3473089,235305,302641,67336,6.2,64,1
15,3694809,212034,238759,26725,9.7,65,1
16,3834706,132400,198440,66040,7.7,66,1
17,3782343,130650,342408,211758,1.8,66,0
18,3958798,79187,268105,188918,0.6,67,1
19,3704188,-254226,69430,323656,16.6,66,-1
20,3739508,25166,159428,134262,9.6,66,0
21,3961280,201881,246632,44751,10.4,67,1
22,4153819,194310,288633,94323,4.0,68,1
23,4714323,520289,552561,32272,4.7,69,1
24,4714323,520289,552561,32272,8.7,69,0
0,30491,0,0,0,6.9,55,0
1,250466,158460,195124,36664,1.5,55,0
2,200484,-41319,23277,64596,11.6,55,0
3,150431,-51914,6769,58683,0.0,55,0
4,149273,-8192,15972,24164,8.7,55,0
5,138776,-11623,5916,17539,10.9,55,0
6,137689,-3120,9892,13012,8.7,55,0
7,133600,-4770,7284,12054,4.2,55,0
8,119807,-13664,4430,18094,5.8,55,0
9,116174,-5299,5003,10302,9.2,55,0
10,100575,-14459,2375,16834,1.2,55,0
11,105513,2198,9034,6836,2.2,54,-1
12,100483,-4960,3750,8710,13.3,54,0
13,132168,29893,33817,3924,7.8,54,0
14,169781,34990,45035,10045,4.5,54,0
15,179323,9717,20756,11039,9.8,54,0
16,222209,41188,59086,17898,2.2,54,0
17,190489,-12860,22107,34967,4.3,54,0
18,178008,-16235,12532,28767,6.3,54,0
19,159231,-19139,3456,22595,9.1,54,0
20,179388,18137,25548,7411,4.7,54,0
21,175980,-3869,12237,16106,7.7,54,0
22,184143,7227,24887,17660,4.2,54,0
23,283212,93260,106962,13702,3.8,55,1
24,283212,93260,106962,13702,0.8,55,0
0,138291,0,0,0,6.2,50,0
1,245486,57398,84308,26910,6.0,50,0
2,237705,-11953,35925,47878,9.0,50,0
3,228955,-14112,17978,32090,3.4,50,0
4,211012,-22083,12629,34712,2.8,50,0
5,160839,-49893,3044,52937,0.0,50,0
6,123015,-40271,204,40475,0.0,50,0
7,104253,-19691,193,19884,0.0,49,-1
8,93290,-11094,530,11624,3.2,49,0
9,94040,-484,2051,2535,5.8,49,0
10,94635,159,3469,3310,5.3,49,0
11,104930,8928,11149,2221,1.3,49,0
12,107423,2531,5714,3183,3.7,49,0
13,106577,-964,3550,4514,1.2,49,0
14,107124,-98,5379,5477,2.7,49,0
15,106020,-1269,2189,3458,7.1,49,0
16,104096,-2240,3018,5258,3.8,49,0
17,85667,-6166,65,6231,0.0,49,0
18,84134,-2269,809,3078,3.0,49,0
19,81982,-2256,322,2578,3.9,49,0
20,81014,-1152,442,1594,4.0,49,0
21,79647,-1471,340,1811,6.2,49,0
22,77150,-2485,271,2756,0.0,49,0
23,75111,-2167,66,2233,0.0,49,0
24,75111,-2167,66,2233,0.0,49,0
0,18135,0,0,0,4.7,55,0
1,55531,20941,28324,7383,12.6,55,0
2,591206,442810,529524,86714,2.4,56,1
3,746903,147838,225622,77784,5.0,57,1
4,731100,-25053,104693,129746,1.8,57,0
5,670292,-65296,33197,98493,11.4,57,0
6,715168,31674,72013,40339,2.7,57,0
7,666244,-47880,30242,78122,0.0,57,0
8,544739,-117675,9208,126883,0.0,56,-1
9,479691,-73101,4860,77961,4.3,55,-1
10,396641,-82349,2636,84985,0.0,54,-1
11,348049,-54608,2343,56951,0.4,54,0
12,321739,-27463,1841,29304,0.0,53,-1
13,289863,-32535,968,33503,0.0,53,0
14,264652,-24955,2154,27109,0.0,52,-1
15,252210,-13405,718,14123,0.5,52,0
16,237450,-15107,631,15738,0.0,52,0
17,213018,-7578,921,8499,0.0,51,-1
18,205328,-8799,602,9401,0.0,51,0
19,197961,-7509,141,7650,0.0,51,0
20,193554,-4546,218,4764,0.1,51,0
21,188914,-4640,169,4809,0.0,51,0
22,184159,-4710,351,5061,5.2,50,-1
23,184002,-610,2014,2624,2.7,50,0
24,184002,-610,2014,2624,3.0,50,0
0,4908,0,0,0,0.7,50,0
1,5753,-417,574,991,3.2,50,0
2,5570,-699,616,1315,0.5,50,0
3,5526,-359,454,813,1.2,50,0
4,5534,-319,499,818,0.0,49,-1
5,5445,-228,378,606,0.0,49,0
6,5262,-292,323,615,1.1,49,0
7,5097,-246,202,448,0.4,49,0
8,4970,-221,236,457,0.0,48,-1
9,4876,-171,118,289,0.0,48,0
10,4725,-225,106,331,0.0,48,0
11,4651,-120,96,216,0.2,48,0
12,4604,-85,82,167,0.3,48,0
13,4592,-53,82,135,0.0,48,0
14,4612,-44,177,221,0.0,47,-1
15,4559,-70,79,149,0.0,47,0
16,4522,-69,123,192,0.0,47,0
17,4421,-37,77,114,4.9,47,0
18,4363,-95,60,155,2.2,47,0
19,4308,-85,25,110,0.0,47,0
20,4253,-69,33,102,1.0,47,0
21,4230,-52,36,88,0.0,47,0
22,4211,-70,47,117,4.5,46,-1
23,4420,165,272,107,3.1,46,0
24,4420,165,272,107,6.0,46,0
0,20257,0,0,0,0.0,45,0
1,19167,-2738,1095,3833,0.0,45,0
2,17003,-2863,1272,4135,2.9,45,0
3,22281,2970,6052,3082,2.2,44,-1
4,30575,6270,13277,7007,2.1,44,0
5,35797,4533,8903,4370,0.0,44,0
6,34251,-1138,2693,3831,1.2,44,0
7,32695,-1648,1431,3079,0.0,44,0
8,30804,-1968,1393,3361,4.1,44,0
9,30969,-323,1565,1888,1.6,44,0
10,29508,-1397,1257,2654,1.3,44,0
11,29642,-261,1580,1841,0.0,44,0
12,28808,-785,693,1478,0.0,44,0
13,27704,-1196,365,1561,0.0,44,0
14,26874,-880,684,1564,1.3,44,0
15,26167,-776,278,1054,0.0,44,0
16,26213,-218,1634,1852,0.7,43,-1
17,33442,1647,4466,2819,0.3,43,0
18,32761,557,4737,4180,0.0,43,0
19,30122,-2614,1091,3705,0.0,43,0
20,27794,-2341,408,2749,0.0,43,0
21,25157,-2662,69,2731,0.0,43,0
22,22781,-2329,137,2466,0.0,43,0
23,21803,-1102,451,1553,0.0,42,-1
24,21803,-1102,451,1553,0.0,42,0
0,3045,0,0,0,0.3,50,0
1,3315,-393,187,580,0.0,50,0
2,3001,-579,211,790,0.0,49,-1
3,2898,-264,180,444,0.0,49,0
4,2709,-314,89,403,0.0,49,0
5,2645,-148,77,225,3.1,48,-1
6,2923,162,327,165,1.0,48,0
7,2927,-43,165,208,0.0,48,0
8,2548,-374,42,416,0.0,48,0
9,2359,-198,21,219,0.0,48,0
10,2265,-105,108,213,0.0,48,0
11,2150,-135,22,157,2.2,48,0
12,2146,-22,18,40,0.1,48,0
13,2172,4,46,42,1.1,48,0
14,2217,5,56,51,0.3,48,0
15,2224,-2,33,35,0.9,48,0
16,2236,-20,37,57,1.0,48,0
17,2286,4,52,48,0.0,48,0
18,2257,-47,25,72,0.0,48,0
19,2224,-44,10,54,0.0,48,0
20,2203,-31,16,47,0.0,48,0
21,2175,-36,10,46,0.0,48,0
22,2160,-33,17,50,0.9,48,0
23,2220,30,78,48,0.5,48,0
24,2220,30,78,48,0.0,48,0
0,97197,0,0,0,4.1,40,0
1,154537,32400,55316,22916,0.0,40,0
2,148434,-9557,17038,26595,0.0,40,0
3,139955,-11097,6023,17120,0.0,40,0
4,130203,-10951,3989,14940,1.4,40,0
5,172872,33635,45391,11756,0.3,40,0
6,182060,10118,22408,12290,0.0,40,0
7,177249,-4223,8753,12976,2.3,40,0
8,173920,-3860,9281,13141,0.0,40,0
9,167999,-6524,2777,9301,0.0,40,0
10,158610,-9034,1942,10976,0.0,40,0
11,154335,-5656,1955,7611,0.0,40,0
12,149670,-4915,1167,6082,0.0,40,0
13,156002,3632,9471,5839,0.2,39,-1
14,173864,13465,21838,8373,2.4,39,0
15,203829,29457,34658,5201,2.3,39,0
16,251921,47415,60058,12643,1.9,39,0
17,367039,46860,70961,24101,2.3,39,0
18,360734,17993,49891,31898,2.3,39,0
19,351465,-9182,13776,22958,2.7,39,0
20,354188,1584,16170,14586,4.0,39,0
21,351586,-3216,15103,18319,6.0,39,0
22,361615,8601,27175,18574,8.1,39,0
23,430005,65842,80519,14677,7.5,39,0
24,430005,65842,80519,14677,1.7,39,0
0,55373,0,0,0,1.8,45,0
1,108204,27672,40170,12498,3.2,45,0
2,115077,1355,18907,17552,3.2,45,0
3,166512,36748,52330,15582,0.3,45,0
4,239566,59536,81587,22051,1.6,45,0
5,255397,16184,30162,13978,2.4,45,0
6,301937,37712,46275,8563,2.7,45,0
7,311335,8611,20451,11840,1.9,45,0
8,300945,-10090,9754,19844,2.0,45,0
9,301635,-1702,7817,9519,5.2,45,0
10,352439,43826,52241,8415,5.4,46,1
11,409595,50380,58168,7788,4.9,46,0
12,423337,13573,23788,10215,2.1,46,0
13,421572,-1904,15291,17195,6.0,46,0
14,433220,8746,25540,16794,4.5,46,0
15,475464,38201,47975,9774,1.0,46,0
16,492569,17051,44161,27110,3.8,46,0
17,517440,14028,57118,43090,0.0,47,1
18,466179,-58108,6429,64537,2.4,47,0
19,453699,-13957,5408,19365,3.9,47,0
20,449538,-5262,6877,12139,3.2,47,0
21,452769,1805,15611,13806,2.3,47,0
22,449567,-2507,19215,21722,0.0,47,0
23,469219,15057,32545,17488,2.6,47,0
24,469219,15057,32545,17488,4.2,47,0
0,87393,0,0,0,0.0,40,0
1,91425,-7471,4858,12329,0.0,40,0
2,88152,-7571,5387,12958,0.0,40,0
3,85332,-5006,2962,7968,0.0,40,0
4,93522,3048,12354,9306,0.0,40,0
5,100377,4355,11160,6805,0.0,40,0
6,100063,-790,5508,6298,0.0,40,0
7,97648,-2790,2803,5593,0.0,40,0
8,95188,-3367,2622,5989,0.0,40,0
9,93879,-1926,1803,3729,0.0,40,0
10,91666,-2560,1554,4114,0.0,40,0
11,94594,1297,4475,3178,0.0,39,-1
12,97141,1643,4341,2698,0.0,39,0
13,97154,72,2853,2781,0.3,39,0
14,107881,7845,11820,3975,0.0,39,0
15,106278,-715,2951,3666,0.0,39,0
16,103039,-3479,1792,5271,0.0,39,0
17,98438,-2228,1239,3467,0.0,39,0
18,95479,-3265,1214,4479,0.0,39,0
19,93319,-2357,526,2883,0.0,39,0
20,91727,-1799,696,2495,0.0,39,0
21,90218,-1824,862,2686,0.0,39,0
22,88723,-1755,1213,2968,0.0,39,0
23,87517,-1552,945,2497,0.0,39,0
24,87517,-1552,945,2497,0.0,39,0
0,52110,0,0,0,0.0,40,0
1,53549,-4600,2303,6903,0.0,40,0
2,51223,-4745,2370,7115,0.0,40,0
3,49511,-2961,1406,4367,0.0,40,0
4,47339,-3266,1217,4483,0.0,40,0
5,47156,-1188,1523,2711,0.0,40,0
6,99980,40230,45880,5650,0.0,39,-1
7,110757,12175,19780,7605,0.0,39,0
8,114617,3509,11800,8291,0.0,39,0
9,113582,-702,4227,4929,0.0,39,0
10,113412,-1233,4475,5708,0.0,39,0
11,111271,-1726,2727,4453,0.0,39,0
12,110637,-1115,2116,3231,0.0,39,0
13,109093,-1686,1471,3157,0.0,39,0
14,108008,-1847,2453,4300,0.0,39,0
15,106025,-2102,885,2987,0.0,39,0
16,101814,-4386,823,5209,0.0,39,0
17,94281,-3233,588,3821,0.0,39,0
18,90764,-3891,505,4396,0.0,39,0
19,88394,-2521,317,2838,0.0,39,0
20,86485,-2078,379,2457,0.0,39,0
21,84535,-2116,412,2528,0.0,39,0
22,82111,-2537,517,3054,0.0,39,0
23,80171,-2178,380,2558,0.0,39,0
24,80171,-2178,380,2558,0.0,39,0
0,33230,0,0,0,4.2,45,0
1,40440,356,5015,4659,3.4,45,0
2,39477,-2971,4413,7384,1.8,45,0
3,40604,-470,2893,3363,1.5,45,0
4,44408,1577,5438,3861,2.1,45,0
5,46458,1282,4124,2842,2.1,45,0
6,65455,15985,18372,2387,1.6,45,0
7,64921,-192,4609,4801,6.6,45,0
8,59778,-5302,1499,6801,6.8,45,0
9,60051,-548,1846,2394,1.3,45,0
10,61901,1212,3393,2181,0.0,45,0
11,49018,-12618,561,13179,0.0,45,0
12,40474,-8766,53,8819,0.0,45,0
13,35375,-5298,49,5347,0.0,44,-1
14,31048,-4296,108,4404,0.0,44,0
15,29599,-1587,30,1617,0.0,44,0
16,27736,-1918,52,1970,0.0,44,0
17,25097,-790,53,843,0.0,44,0
18,24235,-963,110,1073,0.0,43,-1
19,23722,-529,49,578,0.0,43,0
20,23249,-479,35,514,0.0,43,0
21,22719,-536,36,572,0.0,43,0
22,22196,-524,44,568,0.0,43,0
23,21865,-358,31,389,0.0,43,0
24,21865,-358,31,389,0.0,43,0
0,462199,0,0,0,0.0,60,0
1,473291,-46428,50826,97254,0.5,60,0
2,300092,-182141,12046,194187,3.2,59,-1
3,226449,-85415,5636,91051,13.7,58,-1
4,238336,-3674,26310,29984,7.2,58,0
5,234921,-7493,15163,22656,7.4,58,0
6,226276,-11976,9121,21097,0.0,58,0
7,186648,-39191,2981,42172,0.0,58,0
8,160846,-26714,875,27589,2.9,57,-1
9,161153,-2100,3592,5692,1.4,57,0
10,158942,-3316,4149,7465,0.8,57,0
11,158110,-2145,4821,6966,6.7,57,0
12,157382,-1392,3015,4407,15.2,57,0
13,169953,10990,14123,3133,9.5,57,0
14,186665,14188,22241,8053,2.6,57,0
15,189107,2090,12010,9920,10.1,57,0
16,215627,24134,35944,11810,6.0,57,0
17,265356,27899,49540,21641,0.5,57,0
18,256920,-9307,21075,30382,7.4,57,0
19,263278,4605,21730,17125,0.1,57,0
20,226261,-36453,3453,39906,0.0,57,0
21,196346,-30304,535,30839,0.0,57,0
22,172461,-23916,282,24198,0.0,57,0
23,163853,-9404,520,9924,0.0,57,0
24,163853,-9404,520,9924,0.0,57,0
0,0,0,0,0,0.0,40,0
1,5652,2981,3717,736,0.0,40,0
2,8735,1854,2593,739,0.0,40,0
3,16755,5920,7752,1832,0.0,40,0
4,20484,3350,4422,1072,0.0,40,0
5,21145,428,1696,1268,0.0,40,0
6,21946,513,1320,807,0.0,40,0
7,23245,830,1802,972,0.0,40,0
8,23679,375,1021,646,0.0,40,0
9,24316,259,1339,1080,0.0,40,0
10,24955,496,1396,900,0.0,40,0
11,25090,70,801,731,0.0,40,0
12,24989,-148,597,745,0.0,40,0
13,25547,275,944,669,0.0,40,0
14,25536,-41,531,572,0.0,40,0
15,25171,-458,764,1222,0.0,40,0
16,24253,-570,610,1180,0.0,40,0
17,23752,-479,559,1038,0.0,40,0
18,23513,-334,247,581,0.0,40,0
19,23387,-160,245,405,0.0,40,0
20,22948,-477,192,669,0.0,40,0
21,22253,-724,194,918,0.0,40,0
22,21544,-767,217,984,0.0,40,0
23,21544,-767,217,984,0.0,40,0
0,1058,766,894,128,0.0,45,0
1,2277,558,934,376,0.0,45,0
2,2494,-172,596,768,0.0,45,0
3,1920,-602,50,652,0.0,45,0
4,1646,-310,36,346,0.0,44,-1
5,1473,-180,24,204,0.0,44,0
6,1387,-111,60,171,0.0,44,0
7,1334,-62,16,78,0.0,44,0
8,1306,-30,33,63,3.1,44,0
9,1566,176,318,142,0.0,44,0
10,1431,-126,13,139,0.0,44,0
11,1369,-65,11,76,0.0,44,0
12,1534,118,186,68,0.0,44,0
13,1464,-86,55,141,0.0,44,0
14,1365,-103,12,115,0.0,44,0
15,1433,80,131,51,0.0,44,0
16,1686,175,276,101,0.0,44,0
17,1566,-118,23,141,0.0,44,0
18,1475,-92,9,101,0.0,44,0
19,1427,-56,10,66,0.0,44,0
20,1363,-69,19,88,0.0,44,0
21,1422,38,75,37,0.0,44,0
22,1422,38,75,37,3.8,44,0
0,2631,2206,2761,555,1.1,55,0
1,3339,607,1131,524,0.4,55,0
2,3339,-149,563,712,0.0,55,0
3,2661,-706,195,901,0.9,55,0
4,2831,31,495,464,5.5,54,-1
5,5602,2468,2857,389,10.2,54,0
6,28739,21525,23210,1685,5.7,54,0
7,51602,22575,26105,3530,12.3,54,0
8,55651,4604,10404,5800,11.6,54,0
9,52354,-3409,5379,8788,15.2,54,0
10,95030,39779,44355,4576,7.5,54,0
11,123824,29191,38514,9323,6.4,54,0
12,161316,36493,49563,13070,7.9,55,1
13,127644,-18455,13743,32198,2.6,55,0
14,114249,-16447,7674,24121,11.7,54,-1
15,110439,-5085,12468,17553,6.2,54,0
16,98983,-11324,5577,16901,15.1,54,0
17,162039,59791,65282,5491,9.8,53,-1
18,217031,51987,72038,20051,8.6,53,0
19,831839,602264,612271,10007,17.3,54,1
20,831839,602264,612271,10007,11.9,54,0
0,0,0,0,0,0.0,45,0
1,324,190,221,31,0.0,45,0
2,468,92,163,71,0.0,45,0
3,621,98,208,110,0.0,45,0
4,737,61,192,131,0.0,45,0
5,793,21,102,81,0.0,45,0
6,810,-15,75,90,0.0,45,0
7,975,91,197,106,0.0,45,0
8,1006,-5,57,62,0.0,45,0
9,1012,-21,88,109,0.0,45,0
10,1096,18,78,60,0.0,45,0
11,1082,-47,71,118,0.0,45,0
12,1046,-55,23,78,0.0,45,0
13,1045,-11,36,47,0.0,45,0
14,1067,-16,31,47,0.0,45,0
15,1078,-17,50,67,0.0,45,0
16,1119,8,56,48,0.0,45,0
17,1119,8,56,48,0.0,45,0
0,0,0,0,0,0.0,45,0
1,2020,572,848,276,0.0,45,0
2,2300,264,777,513,0.0,45,0
3,2627,194,570,376,0.0,45,0
4,3138,335,780,445,0.0,45,0
5,3305,-32,543,575,0.0,45,0
6,3487,-6,581,587,0.6,45,0
7,4516,811,1392,581,0.0,45,0
8,4516,811,1392,581,0.0,45,0
0,0,0,0,0,0.0,40,0
1,3031,728,1057,329,0.0,40,0
2,3706,628,1258,630,0.0,40,0
3,3992,145,594,449,0.0,40,0
4,4396,238,664,426,0.0,40,0
5,4845,212,739,527,0.0,40,0
6,5536,421,1067,646,0.0,40,0
7,5962,229,843,614,0.0,40,0
8,5962,229,843,614,0.0,40,0
0,0,0,0,0,0.0,45,0
1,215,149,178,29,0.0,45,0
2,532,200,336,136,0.0,45,0
3,532,200,336,136,0.0,45,0
0,12449,0,0,0,0.0,55,0
1,12893,-2488,463,2951,1.4,55,0
2,11446,-2086,458,2544,0.1,54,-1
3,10465,-1318,359,1677,2.9,54,0
4,10186,-814,374,1188,0.0,53,-1
5,9926,-498,300,798,0.1,53,0
6,9783,-347,292,639,0.0,53,0
7,9482,-412,168,580,0.7,53,0
8,10186,314,891,577,12.4,53,0
9,22155,10371,11685,1314,2.1,53,0
10,14048,-6640,603,7243,0.0,53,0
11,11349,-3152,39,3191,0.0,53,0
12,10160,-1239,21,1260,0.0,53,0
13,9426,-763,16,779,0.0,53,0
14,8851,-592,24,616,0.0,53,0
15,8805,-95,78,173,3.4,53,0
16,8887,5,191,186,0.9,53,0
17,8875,-19,150,169,0.2,53,0
18,8875,-19,150,169,0.0,53,0
19,8833,-115,130,245,7.4,53,0
20,8823,-54,98,152,1.3,53,0
21,8912,11,141,130,3.1,53,0
22,8988,-25,139,164,0.7,53,0
23,9034,-49,191,240,0.3,53,0
24,8755,-299,16,315,0.0,53,0
25,8547,-209,18,227,1.1,53,0
0,3680,0,0,0,0.0,50,0
1,3113,-842,74,916,0.0,50,0
2,3224,-322,235,557,0.0,49,-1
3,3000,-424,119,543,0.0,49,0
4,2662,-388,34,422,0.0,49,0
5,2550,-143,20,163,0.0,49,0
6,2384,-176,14,190,0.0,49,0
7,2354,-78,33,111,0.0,49,0
8,3077,421,572,151,0.0,49,0
9,3070,-34,232,266,0.0,49,0
10,3138,-62,172,234,0.0,49,0
11,3080,-125,87,212,0.0,49,0
12,2924,-173,18,191,0.0,49,0
13,2822,-103,21,124,0.0,49,0
14,2712,-110,22,132,0.0,49,0
15,2677,-45,6,51,0.0,49,0
16,2635,-44,15,59,0.0,49,0
17,2578,-20,15,35,0.0,49,0
18,2578,-20,15,35,0.0,49,0
19,2563,-22,31,53,0.0,49,0
20,2564,-5,18,23,0.0,49,0
21,2624,29,65,36,0.0,49,0
22,2687,-4,52,56,0.0,49,0
23,2818,28,95,67,0.0,49,0
24,2886,-22,57,79,0.0,49,0
25,2951,-4,74,78,0.0,49,0
0,120632,0,0,0,7.4,55,0
1,121913,-13907,7259,21166,3.7,55,0
2,111048,-15437,6340,21777,3.4,55,0
3,116057,387,13643,13256,1.6,54,-1
4,105170,-12925,5101,18026,0.3,54,0
5,96966,-9821,2509,12330,4.0,54,0
6,93303,-5076,2717,7793,1.4,53,-1
7,88404,-5552,2077,7629,1.4,53,0
8,88526,-1516,4705,6221,0.9,53,0
9,90909,1323,5304,3981,1.2,53,0
10,89932,-1575,4186,5761,6.2,53,0
11,105559,13343,16817,3474,2.0,53,0
12,118433,12351,16591,4240,3.8,53,0
13,128969,9600,15623,6023,0.9,53,0
14,139507,8799,19816,11017,6.6,53,0
15,137235,-2584,5549,8133,2.2,53,0
16,129494,-8334,4179,12513,3.6,53,0
17,120492,669,7358,6689,4.3,53,0
18,120492,669,7358,6689,5.3,53,0
19,112456,-7669,2413,10082,1.4,53,0
20,105907,-6923,1001,7924,7.6,53,0
21,108548,1829,4966,3137,0.0,53,0
22,103942,-5039,1410,6449,1.0,53,0
23,99885,-4545,2025,6570,1.0,53,0
24,97106,-3431,1077,4508,2.3,53,0
25,99531,1438,5328,3890,4.7,53,0
0,180668,0,0,0,2.3,55,0
1,173807,-19645,8936,28581,2.5,55,0
2,120989,-53638,2080,55718,0.0,54,-1
3,90977,-32279,383,32662,0.0,54,0
4,85042,-8706,2362,11068,6.5,54,0
5,88873,1611,6510,4899,6.4,54,0
6,89692,-175,4713,4888,2.6,54,0
7,88264,-2087,4033,6120,0.6,54,0
8,81251,-7405,2962,10367,0.0,54,0
9,73310,-8284,119,8403,0.6,54,0
10,71591,-2279,1204,3483,6.7,54,0
11,83892,10658,12634,1976,5.1,54,0
12,86591,2684,6041,3357,2.9,54,0
13,89834,2561,6167,3606,6.8,54,0
14,127527,34062,39161,5099,5.3,54,0
15,130990,3796,10424,6628,3.1,54,0
16,131745,-164,10359,10523,2.4,54,0
17,125512,2201,9796,7595,3.1,54,0
18,125512,2201,9796,7595,0.0,54,0
19,106459,-17689,1709,19398,1.4,54,0
20,98589,-8431,641,9072,2.8,54,0
21,97240,-1894,1821,3715,3.8,54,0
22,94283,-3434,1102,4536,1.7,54,0
23,91354,-3395,1413,4808,4.8,54,0
24,89754,-2232,1094,3326,1.5,54,0
25,81942,-7712,322,8034,0.0,54,0
0,18419,0,0,0,0.0,45,0
1,20756,-1474,627,2101,0.0,45,0
2,20341,-1747,606,2353,0.0,45,0
3,20094,-1092,528,1620,2.3,45,0
4,33318,10736,15958,5222,1.9,45,0
5,56189,17928,22406,4478,0.0,45,0
6,38773,-14682,1568,16250,0.0,45,0
7,34343,-4937,774,5711,0.0,44,-1
8,33354,-1768,1342,3110,0.0,44,0
9,32145,-1409,593,2002,0.0,44,0
10,32884,-271,2236,2507,0.0,44,0
11,31514,-1164,1059,2223,0.0,43,-1
12,31046,-674,631,1305,0.0,43,0
13,30524,-659,620,1279,0.0,43,0
14,30297,-452,924,1376,0.0,43,0
15,29979,-480,418,898,0.0,43,0
16,29136,-949,300,1249,0.0,43,0
17,27944,-535,620,1155,0.0,42,-1
18,27944,-535,620,1155,0.0,42,0
19,27722,-461,512,973,0.0,42,0
20,27469,-373,242,615,0.0,42,0
21,27328,-235,262,497,0.0,42,0
22,27383,-126,491,617,0.0,42,0
23,27188,-363,518,881,0.0,42,0
24,27130,-200,406,606,0.0,42,0
25,27326,-32,873,905,1.7,42,0
0,30541,0,0,0,0.0,55,0
1,31597,-4930,1049,5979,0.0,55,0
2,21747,-10463,495,10958,0.0,54,-1
3,17960,-4307,75,4382,0.0,54,0
4,16381,-1846,133,1979,3.0,54,0
5,23811,6299,9654,3355,0.0,54,0
6,20570,-3019,287,3306,0.0,54,0
7,19303,-1561,403,1964,1.2,54,0
8,28520,7036,8323,1287,3.4,54,0
9,54042,20852,23281,2429,0.0,54,0
10,51351,-1133,7737,8870,8.2,54,0
11,107286,47564,51789,4225,2.1,54,0
12,76162,-25985,3242,29227,0.0,54,0
13,64564,-12640,2180,14820,5.7,54,0
14,207432,133656,138631,4975,5.0,55,1
15,167641,-34720,15172,49892,0.0,55,0
16,86340,-81669,1703,83372,0.0,54,-1
17,51911,-11025,1054,12079,0.0,54,0
18,51911,-11025,1054,12079,1.1,54,0
19,49384,-3661,2554,6215,0.9,54,0
20,44471,-5050,1080,6130,0.0,54,0
21,39604,-4888,87,4975,0.0,54,0
22,35796,-3849,52,3901,0.0,54,0
23,33497,-2346,63,2409,0.0,54,0
24,32485,-1090,43,1133,0.0,54,0
25,31629,-867,40,907,0.0,54,0
0,4288,0,0,0,0.0,65,0
1,3332,-1142,45,1187,0.0,65,0
2,2993,-540,98,638,0.0,64,-1
3,3379,-44,242,286,0.0,64,0
4,3515,-254,206,460,0.0,64,0
5,3716,-58,182,240,0.0,64,0
6,3912,-32,187,219,3.5,64,0
7,4344,187,426,239,0.6,64,0
8,4971,268,632,364,0.0,64,0
9,4532,-450,96,546,0.0,64,0
10,4195,-371,19,390,0.0,64,0
11,4043,-175,30,205,0.0,64,0
12,3978,-70,13,83,0.0,64,0
13,3927,-56,23,79,0.0,64,0
14,3869,-71,39,110,0.0,64,0
15,3908,11,56,45,0.0,64,0
16,4050,55,127,72,3.6,64,0
17,4750,300,455,155,3.5,64,0
18,4750,300,455,155,8.6,64,0
19,5100,126,475,349,0.0,64,0
20,5039,-137,128,265,8.8,64,0
21,6467,1241,1484,243,3.0,64,0
22,6262,-405,487,892,0.5,64,0
23,6070,-370,336,706,0.1,64,0
24,5977,-254,177,431,2.4,64,0
25,6075,-59,267,326,0.0,64,0
0,3207,0,0,0,0.0,65,0
1,2877,-709,101,810,0.0,65,0
2,2267,-712,68,780,0.0,64,-1
3,2031,-315,57,372,0.0,64,0
4,1891,-215,74,289,0.0,64,0
5,1831,-96,56,152,0.0,64,0
6,1808,-57,40,97,0.0,64,0
7,1778,-49,51,100,0.0,64,0
8,1760,-44,57,101,0.0,63,-1
9,1760,-8,29,37,0.0,63,0
10,1762,-9,41,50,0.0,63,0
11,1761,-9,37,46,0.0,63,0
12,2305,484,566,82,0.0,63,0
13,2586,192,414,222,3.0,63,0
14,3821,1009,1341,332,2.3,63,0
15,4010,110,498,388,0.0,63,0
16,3782,-317,299,616,0.4,63,0
17,3763,-21,235,256,0.0,63,0
18,3763,-21,235,256,1.5,63,0
19,3671,-257,156,413,0.0,63,0
20,3579,-161,59,220,0.3,63,0
21,3593,-57,114,171,1.4,63,0
22,3646,-56,112,168,0.0,63,0
23,3659,-94,115,209,0.2,63,0
24,3684,-82,68,150,0.0,63,0
25,3747,-30,117,147,0.0,63,0
0,248434,0,0,0,5.1,95,0
1,222969,-59165,10158,69323,10.7,94,-1
2,210870,-28847,13596,42443,5.5,94,0
3,204773,-16123,18066,34189,9.1,94,0
4,199223,-15457,14846,30303,6.2,93,-1
5,190454,-13487,11983,25470,10.3,93,0
6,191798,-3241,9152,12393,1.3,93,0
7,173034,-19985,3062,23047,1.9,92,-1
8,166537,-10384,4910,15294,16.5,92,0
9,173092,3321,9446,6125,4.3,92,0
10,172827,-1862,8725,10587,0.9,92,0
11,172561,-2179,8162,10341,6.4,92,0
12,167066,-6102,2749,8851,17.0,92,0
13,189554,19790,23742,3952,13.3,92,0
14,398837,191422,201664,10242,5.9,93,1
15,387249,-3762,35416,39178,8.1,93,0
16,366674,-23880,26722,50602,4.4,93,0
17,418137,74161,105740,31579,13.6,93,0
18,418137,74161,105740,31579,2.7,93,0
19,347315,-49410,26275,75685,13.4,93,0
20,539192,184640,205875,21235,3.5,94,1
21,678676,137035,165810,28775,5.4,95,1
22,558842,-119394,21497,140891,4.6,94,-1
23,431647,-126440,12996,139436,18.4,93,-1
24,408949,-30468,15096,45564,8.1,93,0
25,372009,-37903,16698,54601,4.7,92,-1
0,1528505,0,0,0,7.5,65,0
1,1789483,-30121,83401,113522,1.5,65,0
2,1978302,42574,162364,119790,4.7,65,0
3,2027164,-19730,78189,97919,1.6,65,0
4,1938488,-133107,52375,185482,0.0,65,0
5,997588,-928412,1728,930140,0.0,64,-1
6,758415,-275779,441,276220,0.0,64,0
7,669379,-95201,311,95512,0.0,63,-1
8,613169,-57899,526,58425,0.0,63,0
9,596359,-19191,353,19544,0.0,63,0
10,580747,-16286,384,16670,0.0,63,0
11,570194,-11350,343,11693,0.0,63,0
12,564759,-6001,167,6168,0.0,63,0
13,559460,-5548,138,5686,0.0,63,0
14,550022,-9548,406,9954,0.0,63,0
15,547111,-3480,226,3706,0.0,63,0
16,543163,-4138,279,4417,0.0,63,0
17,534594,-2111,110,2221,0.0,63,0
18,534594,-2111,110,2221,0.0,63,0
19,530029,-4846,302,5148,0.0,63,0
20,528103,-2232,195,2427,0.0,63,0
21,526025,-2241,184,2425,0.0,63,0
22,522821,-3253,192,3445,0.0,63,0
23,519743,-3418,238,3656,0.0,63,0
24,517403,-2592,219,2811,0.0,63,0
25,515338,-2310,294,2604,0.0,63,0
0,807314,0,0,0,13.4,120,0
1,585445,-256786,12313,269099,13.6,119,-1
2,704103,55243,122337,67094,15.4,119,0
3,557038,-160742,185786,346528,0.0,119,0
4,463038,-103546,77042,180588,13.2,119,0
5,651187,157162,180105,22943,8.9,120,1
6,734819,78735,99064,20329,7.3,120,0
7,693494,-38091,25243,63334,3.1,120,0
8,992835,261318,315799,54481,11.6,121,1
9,920989,-50495,52876,103371,0.0,121,0
10,739736,-173800,9582,183382,6.9,120,-1
11,715055,-43976,37854,81830,1.4,120,0
12,610135,-100410,5798,106208,10.5,119,-1
13,576023,-38831,22367,61198,10.5,119,0
14,600387,16621,56403,39782,12.1,119,0
15,623292,22987,40708,17721,5.3,119,0
16,624281,-31,33743,33774,14.6,119,0
17,590434,21570,53013,31443,6.5,119,0
18,590434,21570,53013,31443,17.7,119,0
19,555815,-18513,37728,56241,18.3,118,-1
20,679060,117267,133579,16312,0.0,118,0
21,554441,-120422,33770,154192,0.0,119,1
22,455435,-99687,3267,102954,4.6,119,0
23,437503,-19946,13156,33102,8.3,119,0
24,434022,-5872,15325,21197,5.9,118,-1
25,421047,-14638,14375,29013,3.9,118,0
0,721549,0,0,0,0.4,60,0
1,733175,-92351,10612,102963,4.7,60,0
2,902272,52773,109547,56774,2.4,60,0
3,992958,33373,78278,44905,0.0,60,0
4,637763,-343933,18726,362659,0.0,60,0
5,528240,-129425,1052,130477,1.5,59,-1
6,545158,322,19598,19276,1.8,59,0
7,539346,-10339,9343,19682,1.2,59,0
8,540815,-7955,10063,18018,3.3,59,0
9,560510,10526,19331,8805,2.0,59,0
10,504953,-51069,5514,56583,0.0,59,0
11,478300,-31136,1387,32523,3.4,59,0
12,475804,-5110,3268,8378,1.4,59,0
13,487264,7613,13313,5700,2.5,59,0
14,515541,18294,26567,8273,1.6,59,0
15,515454,-622,8025,8647,1.6,59,0
16,521862,3003,13225,10222,1.0,59,0
17,537228,8301,18893,10592,3.4,59,0
18,537228,8301,18893,10592,2.0,59,0
19,534776,-734,14269,15003,1.4,59,0
20,540649,3224,10666,7442,1.5,59,0
21,551697,7864,15511,7647,0.0,59,0
22,517881,-34326,3489,37815,0.4,59,0
23,500779,-18825,3054,21879,2.5,59,0
24,492778,-10211,3528,13739,2.9,59,0
25,484298,-9836,3663,13499,0.0,59,0
0,76886,0,0,0,0.7,55,0
1,97248,-5274,11366,16640,2.3,55,0
2,101976,-5113,13226,18339,3.2,55,0
3,113304,4503,17540,13037,3.3,55,0
4,107480,-10195,7735,17930,1.9,55,0
5,111214,-640,10448,11088,2.0,55,0
6,96669,-15582,5467,21049,0.0,55,0
7,74391,-22355,169,22524,0.0,54,-1
8,65006,-9907,199,10106,2.2,54,0
9,68979,2621,4463,1842,2.6,54,0
10,70562,905,3563,2658,1.8,54,0
11,73000,1676,4318,2642,3.0,54,0
12,75198,1731,3773,2042,2.3,54,0
13,77333,1559,3996,2437,2.9,54,0
14,80307,1897,6163,4266,1.9,54,0
15,80450,-152,2269,2421,2.6,54,0
16,79897,-1041,2393,3434,2.0,54,0
17,79221,463,2411,1948,3.0,54,0
18,79221,463,2411,1948,1.2,54,0
19,78133,-1410,2175,3585,0.0,54,0
20,73583,-4633,378,5011,0.0,54,0
21,69704,-3936,45,3981,0.0,54,0
22,66658,-3091,49,3140,0.8,54,0
23,65651,-1269,407,1676,0.0,54,0
24,63710,-1953,28,1981,0.0,54,0
25,62448,-1289,49,1338,0.0,54,0
0,1883241,0,0,0,32.8,120,0
1,2378499,156301,311338,155037,12.8,120,0
2,2576134,95854,232019,136165,7.8,121,1
3,2941545,279768,343946,64178,16.4,122,1
4,3337859,330864,392085,61221,16.5,123,1
5,3490524,138491,191448,52957,9.7,123,0
6,3491118,-8171,75003,83174,11.0,124,1
7,3473894,-21187,58253,79440,11.3,124,0
8,2049762,-1347561,47839,1395400,0.0,123,-1
9,2222608,56393,211556,155163,3.4,122,-1
10,2290651,66389,152729,86340,10.9,122,0
11,2709743,382059,401154,19095,7.7,123,1
12,2635318,-49191,88018,137209,14.4,123,0
13,2925498,264071,280489,16418,12.7,124,1
14,3477161,508149,520607,12458,5.3,126,1
15,3544294,79807,108826,29019,3.3,126,0
16,3563431,12437,87003,74566,4.5,126,0
17,3168283,89606,195898,106292,8.1,125,-1
18,3168283,89606,195898,106292,6.7,125,0
19,2966969,-142302,130312,272614,5.6,125,0
20,3022589,45974,146599,100625,17.6,125,0
21,3650389,610263,620430,10167,5.4,126,1
22,3553316,-96151,93024,189175,7.0,127,1
23,3391563,-151539,56204,207743,10.5,126,-1
24,3470984,45690,99214,53524,7.3,126,0
25,3327142,-144540,71659,216199,7.6,126,0
0,766431,0,0,0,4.7,70,0
1,807793,-47931,52291,100222,5.1,70,0
2,866682,10264,111207,100943,9.6,70,0
3,1025161,108222,153683,45461,8.3,70,0
4,1122717,70877,175983,105106,8.6,70,0
5,1389355,233298,277246,43948,6.7,71,1
6,1430907,40402,97685,57283,2.9,71,0
7,1316396,-111027,30057,141084,2.5,71,0
8,1264038,-59878,88812,148690,8.6,71,0
9,1496252,193664,218782,25118,3.9,71,0
10,1377655,-83918,55934,139852,5.9,72,1
11,1436427,19641,66761,47120,5.2,72,0
12,1369429,-59078,16477,75555,10.5,72,0
13,1425120,41753,66773,25020,9.6,72,0
14,1712964,261028,283955,22927,5.0,73,1
15,1759949,50422,87784,37362,6.7,73,0
16,1807073,39739,84844,45105,10.1,74,1
17,1664698,-17952,60295,78247,5.2,74,0
18,1664698,-17952,60295,78247,8.8,74,0
19,1591449,-68822,43894,112716,2.6,74,0
20,1583443,-13464,49338,62802,2.8,74,0
21,1640207,50230,82210,31980,3.1,74,0
22,1544680,-98129,25857,123986,1.9,74,0
23,1397371,-144248,17300,161548,6.3,73,-1
24,1329290,-80075,16641,96716,4.9,73,0
25,1233193,-96301,16811,113112,6.8,72,-1
0,71975,0,0,0,0.0,55,0
1,73570,-11541,4807,16348,0.0,55,0
2,62771,-14833,3222,18055,0.0,54,-1
3,56555,-8950,1956,10906,0.0,54,0
4,53159,-6055,2370,8425,0.0,53,-1
5,51215,-3327,1728,5055,0.0,53,0
6,49089,-3072,898,3970,0.0,53,0
7,47462,-2159,770,2929,0.0,52,-1
8,47012,-1444,1321,2765,0.0,52,0
9,46714,-817,796,1613,0.0,52,0
10,46368,-877,888,1765,0.0,52,0
11,46267,-623,907,1530,0.3,52,0
12,46369,-244,710,954,0.0,52,0
13,46209,-434,627,1061,0.0,52,0
14,45826,-758,873,1631,0.0,52,0
15,45807,-252,458,710,0.0,52,0
16,45591,-482,496,978,0.0,52,0
17,46344,282,1053,771,0.2,52,0
18,46344,282,1053,771,4.0,52,0
19,46781,6,1391,1385,0.2,52,0
20,47032,-19,880,899,4.4,52,0
21,48444,1037,1977,940,2.0,52,0
22,48840,-164,1400,1564,0.0,52,0
23,48870,-503,1425,1928,0.0,52,0
24,48513,-637,1052,1689,0.0,51,-1
25,50182,979,2625,1646,0.0,51,0
0,3227802,0,0,0,3.8,75,0
1,3097107,-331983,39515,371498,5.4,75,0
2,3020468,-186261,90839,277100,9.2,75,0
3,3037764,-50240,81298,131538,5.3,75,0
4,2815810,-250781,65251,316032,3.7,75,0
5,2588416,-250665,54191,304856,8.5,75,0
6,2437601,-172615,35782,208397,5.7,74,-1
7,2162671,-276861,15110,291971,3.5,74,0
8,1423974,-713796,4542,718338,0.0,73,-1
9,1132771,-333503,413,333916,0.0,73,0
10,997109,-141717,1759,143476,1.3,72,-1
11,1023238,12835,34365,21530,3.5,72,0
12,1014658,-8134,9798,17932,5.2,72,0
13,1029122,10375,23556,13181,6.5,72,0
14,1121933,82689,97698,15009,10.7,72,0
15,1132188,10705,30958,20253,5.2,72,0
16,1135896,517,24564,24047,4.3,73,1
17,1080795,-12547,14182,26729,4.1,73,0
18,1080795,-12547,14182,26729,11.1,73,0
19,1050665,-30804,9372,40176,10.2,73,0
20,1143437,85047,98165,13118,1.9,73,0
21,1249060,101490,112597,11107,5.4,73,0
22,1215348,-34929,23766,58695,5.7,74,1
23,1167010,-50821,19058,69879,9.0,74,0
24,1146999,-26468,17089,43557,6.9,74,0
25,1114153,-35701,14915,50616,10.2,74,0
0,292725,0,0,0,2.0,55,0
1,279462,-44329,13153,57482,0.0,55,0
2,194079,-88926,6894,95820,2.9,54,-1
3,188476,-14072,11836,25908,1.3,54,0
4,174946,-16840,7914,24754,1.0,54,0
5,202206,19996,33204,13208,3.1,54,0
6,215325,10785,21426,10641,1.9,54,0
7,205574,-10349,8716,19065,0.3,54,0
8,150419,-54809,5300,60109,0.0,54,0
9,125609,-27431,87,27518,0.0,53,-1
10,112541,-13489,75,13564,0.0,53,0
11,106048,-7007,81,7088,0.0,53,0
12,102824,-3382,40,3422,0.0,53,0
13,100323,-2600,37,2637,0.0,53,0
14,96807,-3510,102,3612,0.0,53,0
15,95552,-1380,59,1439,0.0,53,0
16,94154,-1434,67,1501,0.0,52,-1
17,91374,-668,29,697,0.0,52,0
18,91374,-668,29,697,0.0,52,0
19,89965,-1444,67,1511,0.0,52,0
20,89383,-621,33,654,0.0,52,0
21,88777,-642,36,678,0.0,52,0
22,87902,-885,63,948,0.0,52,0
23,87001,-938,61,999,0.0,52,0
24,86403,-634,48,682,0.0,52,0
25,85845,-567,39,606,0.0,52,0
0,66891,0,0,0,3.5,55,0
1,58956,-13741,3538,17279,1.4,55,0
2,46684,-13990,3822,17812,3.9,54,-1
3,45659,-2724,5332,8056,4.8,54,0
4,31784,-14036,1144,15180,0.0,54,0
5,24629,-7675,109,7784,0.0,53,-1
6,21189,-3745,28,3773,0.0,53,0
7,19163,-2133,148,2281,0.0,52,-1
8,18694,-773,594,1367,4.0,52,0
9,17536,-1196,179,1375,0.0,52,0
10,16404,-1141,47,1188,0.0,52,0
11,16291,-257,267,524,0.0,52,0
12,15955,-369,89,458,0.0,52,0
13,15910,-93,266,359,3.4,52,0
14,16432,351,800,449,0.0,52,0
15,15915,-524,89,613,0.0,52,0
16,15401,-524,14,538,0.0,52,0
17,14697,-195,8,203,0.0,52,0
18,14697,-195,8,203,0.0,52,0
19,14377,-329,9,338,0.0,52,0
20,14233,-157,10,167,0.0,52,0
21,14098,-137,11,148,0.0,52,0
22,13955,-139,28,167,0.0,52,0
23,13801,-161,14,175,0.0,52,0
24,13748,-62,22,84,0.0,52,0
25,13897,79,171,92,0.1,52,0
0,32021,0,0,0,1.8,45,0
1,39108,1261,7758,6497,0.0,45,0
2,35932,-3940,3803,7743,0.0,45,0
3,34080,-2527,2244,4771,0.7,45,0
4,31006,-3569,1501,5070,0.0,45,0
5,37040,3968,8196,4228,0.0,44,-1
6,37339,285,3639,3354,2.7,44,0
7,38133,154,3807,3653,0.0,44,0
8,39718,713,4813,4100,5.5,44,0
9,46404,5568,8642,3074,0.5,44,0
10,50728,3416,7916,4500,4.2,44,0
11,60971,10235,14247,4012,10.1,44,0
12,77318,15969,19351,3382,10.8,44,0
13,109308,31025,34938,3913,0.5,44,0
14,127894,17572,28601,11029,2.1,44,0
15,132195,4117,13165,9048,0.9,44,0
16,131810,-749,13809,14558,0.0,44,0
17,107587,-10021,7617,17638,0.3,44,0
18,107587,-10021,7617,17638,0.0,44,0
19,93595,-14792,3503,18295,0.4,44,0
20,76763,-17001,943,17944,3.9,44,0
21,71019,-6090,1442,7532,1.5,44,0
22,64720,-6465,699,7164,3.7,44,0
23,60339,-4505,2050,6555,1.6,44,0
24,58900,-2066,2297,4363,3.0,44,0
25,63292,3257,8010,4753,13.5,44,0
0,270752,0,0,0,0.0,40,0
1,275280,-18517,15083,33600,0.0,40,0
2,263809,-20357,18561,38918,0.0,40,0
3,252440,-15200,10473,25673,0.0,40,0
4,240803,-14775,9328,24103,0.0,40,0
5,238022,-5766,9901,15667,0.0,40,0
6,235543,-3798,7495,11293,0.0,40,0
7,249938,6699,20719,14020,0.0,39,-1
8,281965,23729,39691,15962,1.9,39,0
9,301753,20552,31454,10902,0.0,39,0
10,366610,43116,55010,11894,1.4,39,0
11,411551,60035,74664,14629,2.5,39,0
12,418291,11384,24315,12931,0.0,40,1
13,416867,-1078,15892,16970,0.0,40,0
14,407293,-10205,19209,29414,0.0,40,0
15,396330,-11801,8253,20054,0.0,40,0
16,369474,-27006,4693,31699,0.0,40,0
17,337035,-15414,9098,24512,0.0,39,-1
18,337035,-15414,9098,24512,0.0,39,0
19,314296,-20033,4171,24204,0.0,39,0
20,298941,-15660,1440,17100,0.0,39,0
21,286338,-12922,1478,14400,0.0,39,0
22,277703,-9295,3508,12803,0.0,38,-1
23,298323,13463,28350,14887,0.0,38,0
24,306233,10353,21911,11558,0.0,38,0
25,342532,20990,41895,20905,0.0,38,0
0,215812,0,0,0,0.0,65,0
1,147855,-58615,6037,36894,0.0,64,-1
2,112469,-34280,2068,36348,5.9,63,-1
3,153894,31250,54964,23714,8.4,63,0
4,138715,-14783,22001,36784,3.5,63,0
5,118661,-21118,6886,28004,6.2,63,0
6,172945,46910,56527,9617,5.6,63,0
7,541171,343846,360151,16305,4.2,64,1
8,878730,307928,353031,45103,14.1,65,1
9,1685758,783351,803730,20379,6.8,67,1
10,2277609,570459,600538,30079,1.3,69,1
11,2126053,-105560,185347,290907,0.0,70,1
12,835528,-1285903,5235,1291138,0.0,69,-1
13,461182,-394272,734,395006,0.0,68,-1
14,308316,-154517,1017,155534,0.0,67,-1
15,275869,-36073,369,36442,0.0,67,0
16,245728,-30787,474,31261,0.0,67,0
17,208858,-9977,285,10262,0.0,66,-1
18,208858,-9977,285,10262,0.0,66,0
19,198367,-11164,1066,12230,0.0,66,0
20,192952,-5603,558,6161,0.0,66,0
21,189115,-3976,980,4956,0.0,66,0
22,182887,-6189,596,6785,0.0,66,0
23,176574,-6297,788,7085,0.0,66,0
24,172746,-4081,248,4329,0.0,66,0
25,180465,7243,11541,4298,0.0,66,0
0,56428,38957,44312,5355,2.2,60,0
1,249668,143807,181207,37400,0.0,60,0
2,166362,-76846,34170,111016,0.0,60,0
3,141678,-33810,18888,52698,5.5,60,0
4,135098,-9675,13627,23302,0.0,60,0
5,121441,-15059,4888,19947,0.0,60,0
6,100549,-21176,2441,23617,0.0,59,-1
7,86847,-14254,2301,16555,0.0,59,0
8,81061,-6899,1474,8373,0.0,58,-1
9,69024,-12073,514,12587,0.0,58,0
10,63270,-6273,234,6507,0.0,58,0
11,60536,-2919,206,3125,0.0,58,0
12,58896,-1734,622,2356,0.0,57,-1
13,57582,-1397,1554,2951,0.0,57,0
14,57516,-206,1008,1214,1.8,57,0
15,70673,12431,14312,1881,6.4,57,0
16,97424,16115,19711,3596,6.6,57,0
17,97424,16115,19711,3596,5.3,57,0
18,101986,4791,14947,10156,1.1,57,0
19,95262,-7225,3763,10988,6.4,57,0
20,95253,-1035,5293,6328,3.1,57,0
21,90267,-6042,2761,8803,2.2,57,0
22,83795,-7373,2763,10136,2.2,56,-1
23,80269,-4474,1825,6299,4.4,56,0
24,80413,-810,4047,4857,3.8,56,0
0,0,0,0,0,0.0,45,0
1,446,162,227,65,0.0,45,0
2,640,22,113,91,0.0,45,0
3,758,-50,45,95,0.0,45,0
4,848,-32,31,63,0.0,45,0
5,1000,-11,61,72,0.0,45,0
6,1045,-23,25,48,0.0,45,0
7,8383,4993,5353,360,2.8,45,0
8,30028,18861,21574,2713,0.0,45,0
9,19451,-8086,1170,9256,0.0,45,0
10,15667,-4233,437,4670,0.0,45,0
11,12998,-2938,332,3270,0.0,45,0
12,12014,-1229,144,1373,0.0,45,0
13,10818,-1330,164,1494,0.0,45,0
14,9222,-784,155,939,0.0,45,0
15,9222,-784,155,939,0.0,45,0
16,8870,-604,153,757,0.0,45,0
17,8591,-363,60,423,0.0,45,0
18,8307,-355,53,408,3.0,45,0
19,8984,395,776,381,0.0,45,0
20,8816,-352,349,701,0.0,45,0
21,8626,-343,137,480,0.0,45,0
22,8772,-38,472,510,0.0,45,0
0,0,0,0,0,0.0,40,0
1,1380,873,1054,181,3.4,40,0
2,32747,27137,30332,3195,0.0,40,0
3,54385,19380,26820,7440,0.0,40,0
4,51241,-934,6391,7325,2.7,40,0
5,77075,18768,24211,5443,0.0,40,0
6,66757,-4462,4844,9306,0.0,40,0
7,64080,-3368,2869,6237,0.0,40,0
8,59661,-4614,2189,6803,0.0,40,0
9,53874,-6187,2439,8626,0.0,40,0
10,50810,-3426,1463,4889,1.9,40,0
11,63504,11692,17471,5779,0.0,40,0
12,58147,-3577,6511,10088,0.0,40,0
13,58147,-3577,6511,10088,0.0,40,0
14,49970,-6826,1903,8729,0.7,40,0
15,47731,-2533,2618,5151,2.2,40,0
16,55329,7079,10249,3170,1.5,40,0
17,52730,-2766,2910,5676,0.0,40,0
18,48331,-4511,2147,6658,0.0,40,0
19,45562,-3215,914,4129,2.0,40,0
20,53275,6347,11738,5391,3.6,40,0
0,0,0,0,0,0.0,40,0
1,3449,2682,3000,318,0.0,40,0
2,5155,1430,2683,1253,0.0,40,0
3,5370,97,778,681,0.0,40,0
4,6158,344,1107,763,0.0,40,0
5,6327,110,862,752,0.0,40,0
6,6606,75,595,520,3.1,40,0
7,25204,17391,18435,1044,0.0,40,0
8,24299,-681,4097,4778,0.9,40,0
9,34342,9237,11607,2370,0.0,40,0
10,32254,-1871,5077,6948,0.0,40,0
11,26386,-3426,2305,5731,0.0,40,0
12,26386,-3426,2305,5731,0.0,40,0
13,23279,-3307,1092,4399,0.0,40,0
14,21096,-2300,663,2963,0.0,40,0
15,19000,-2198,363,2561,0.0,40,0
16,17463,-1741,333,2074,0.0,40,0
17,16307,-1327,449,1776,0.0,40,0
18,15678,-815,244,1059,0.0,40,0
19,14609,-1210,353,1563,0.0,40,0
0,0,0,0,0,0.0,45,0
1,69,39,49,10,0.0,45,0
2,150,30,62,32,0.0,45,0
3,184,-2,38,40,0.0,45,0
4,211,-1,29,30,0.0,45,0
5,225,0,33,33,0.0,45,0
6,267,2,40,38,0.0,45,0
7,284,-4,10,14,0.0,45,0
8,291,-8,13,21,0.0,45,0
9,344,-7,17,24,0.0,45,0
10,344,-7,17,24,0.0,45,0
11,351,-10,26,36,0.0,45,0
12,357,-4,15,19,0.0,45,0
13,359,-5,12,17,0.0,45,0
14,382,7,25,18,0.0,45,0
15,401,-3,29,32,0.0,45,0
16,435,12,32,20,0.0,45,0
17,462,7,36,29,0.0,45,0
0,0,0,0,0,0.0,45,0
1,24,14,20,6,0.0,45,0
2,56,12,19,7,0.0,45,0
3,123,21,49,28,0.0,45,0
4,133,0,9,9,0.0,45,0
5,147,-1,21,22,0.0,45,0
6,220,2,21,19,0.0,45,0
7,220,2,21,19,0.0,45,0
8,258,7,38,31,0.0,45,0
9,247,-18,20,38,0.0,45,0
10,265,2,18,16,0.0,45,0
11,306,19,53,34,0.0,45,0
12,329,-4,45,49,0.0,45,0
13,335,-12,18,30,0.0,45,0
14,364,13,56,43,0.0,45,0
0,2411,2327,2416,89,0.0,50,0
1,6936,4096,4915,819,0.0,50,0
2,10096,2736,4343,1607,1.1,50,0
3,22245,11550,14740,3190,1.8,50,0
4,29699,6505,12473,5968,1.5,50,0
0,1280,1219,1280,61,0.0,50,0
1,2496,1004,1472,468,0.0,50,0
2,2393,-255,442,697,0.0,50,0
3,1929,-532,110,642,0.0,50,0
4,1893,-196,228,424,0.0,49,-1
0,0,0,0,0,0.0,40,0
0,0,0,0,0,0.0,40,0
0,81124,1626,7521,5895,2.4,55,0
1,102781,10459,20444,9985,4.9,55,0
2,101126,-4570,5311,9881,0.4,55,0
3,94942,-9070,2971,12041,0.0,55,0
4,80925,-14959,2147,17106,0.0,55,0
5,63220,-18411,64,18475,0.0,54,-1
6,55577,-8059,29,8088,0.0,54,0
7,50531,-5189,45,5234,0.0,54,0
8,49808,-1093,585,1678,0.6,54,0
9,50851,519,1426,907,0.0,54,0
10,50222,-877,489,1366,1.9,54,0
11,52204,1469,1972,503,0.0,54,0
12,51757,-586,859,1445,0.0,54,0
13,52256,-131,1793,1924,1.0,54,0
14,52942,-216,966,1182,0.3,54,0
15,58206,1908,3853,1945,0.0,54,0
16,55600,-252,1209,1461,2.1,54,0
17,55600,-252,1209,1461,0.0,54,0
18,56449,200,1698,1498,0.0,54,0
19,55551,-1058,676,1734,4.5,54,0
20,57047,1102,1682,580,0.0,54,0
21,56794,-657,1068,1725,0.0,54,0
22,54418,-2559,702,3261,0.0,54,0
23,54418,-2559,702,3261,0.0,54,0
24,52831,-1806,281,2087,4.1,54,0
25,55612,2151,2889,738,3.7,54,0
0,235327,-37798,45002,82800,0.0,105,0
1,116374,-118886,10519,129405,0.0,104,-1
2,97547,-24868,524,25392,0.0,104,0
3,98872,-1486,14179,15665,4.9,104,0
4,220389,107707,117690,9983,0.9,104,0
5,107315,-104570,4479,109049,0.0,103,-1
6,93498,-16010,282,16292,0.0,103,0
7,89559,-4570,1589,6159,0.0,103,0
8,104850,12792,15680,2888,0.0,103,0
9,91044,-12126,2158,14284,0.0,103,0
10,93629,1200,5728,4528,0.0,103,0
11,96807,2731,6707,3976,0.8,103,0
12,105230,7838,11236,3398,0.0,103,0
13,116353,8835,16607,7772,3.8,103,0
14,112496,-2550,6226,8776,0.0,103,0
15,117764,1908,20105,18197,0.0,103,0
16,95277,-18869,151,19020,0.0,103,0
17,95277,-18869,151,19020,0.0,103,0
18,90519,-6620,620,7240,0.0,103,0
19,89136,-1535,516,2051,0.0,103,0
20,88781,-430,1000,1430,0.0,103,0
21,87736,-1127,380,1507,0.0,103,0
22,88195,167,1695,1528,0.0,103,0
23,88195,167,1695,1528,0.0,103,0
24,90832,2124,3554,1430,0.0,103,0
25,94076,2357,5056,2699,2.4,103,0
0,356412,5851,32197,26346,4.2,60,0
1,401231,11411,47840,36429,3.3,60,0
2,379917,-31558,14145,45703,2.9,60,0
3,376629,-19041,18520,37561,2.0,60,0
4,438663,46626,62953,16327,5.9,60,0
5,479345,32207,52437,20230,6.4,60,0
6,571868,77395,94685,17290,0.0,61,1
7,638306,49683,80688,31005,2.2,61,0
8,744826,87074,115142,28068,3.9,61,0
9,961714,186268,203010,16742,0.0,62,1
10,837142,-89183,17628,106811,2.4,62,0
11,904810,49611,67815,18204,1.6,62,0
12,857408,-43086,18452,61538,2.3,62,0
13,720236,-140908,67539,208447,0.0,62,0
14,480573,-88426,556,88982,0.0,61,-1
15,529253,-8834,39885,48719,0.0,61,0
16,468150,-9386,10834,20220,1.2,61,0
17,468150,-9386,10834,20220,0.1,61,0
18,445371,-25549,8716,34265,0.0,61,0
19,438732,-8593,6346,14939,2.1,61,0
20,446812,5990,11544,5554,0.0,61,0
21,436412,-11982,5071,17053,0.0,61,0
22,428109,-10814,10255,21069,0.0,61,0
23,428109,-10814,10255,21069,3.2,61,0
24,417686,-12237,3555,15792,0.0,61,0
25,406382,-12617,3022,15639,2.6,61,0
0,38249,2066,7304,5238,0.0,55,0
1,23822,-14468,1806,16274,0.0,55,0
2,19094,-5634,156,5790,0.0,54,-1
3,16192,-3182,143,3325,1.7,54,0
4,17748,824,1877,1053,4.0,54,0
5,20454,1955,3314,1359,0.1,54,0
6,19857,-857,1547,2404,3.9,54,0
7,20372,-92,1773,1865,0.0,54,0
8,20177,-499,1174,1673,4.3,54,0
9,20865,350,1829,1479,2.7,54,0
10,19869,-1117,833,1950,0.0,54,0
11,19835,-214,926,1140,18.2,54,0
12,25035,4633,5484,851,5.0,54,0
13,29468,3693,6140,2447,8.8,54,0
14,31194,-1276,3346,4622,10.1,54,0
15,350015,145778,165153,19375,6.0,54,0
16,243089,64588,92375,27787,8.6,55,1
17,243089,64588,92375,27787,15.7,55,0
18,762066,505683,535207,29524,12.0,56,1
19,1445880,674097,687138,13041,6.9,58,1
20,1510992,67503,129607,62104,10.5,58,0
21,1580412,63017,138533,75516,15.3,59,1
22,2421379,788107,806253,18146,16.4,60,1
23,2421379,788107,806253,18146,0.0,60,0
24,2511151,120613,365022,244409,5.4,61,1
25,2989456,442249,508625,66376,1.1,62,1
0,2063222,344561,447375,102814,22.1,115,0
1,2937597,732522,817530,85008,6.3,116,1
2,3145452,162180,280249,118069,14.4,117,1
3,1796464,-1309566,72478,1382044,0.0,116,-1
4,1100973,-742123,4829,746952,3.8,115,-1
5,1151266,6991,85335,78344,9.6,115,0
6,1180915,21965,64223,42258,6.8,115,0
7,1326217,128886,190996,62110,15.6,116,1
8,1440445,98053,157541,59488,10.9,116,0
9,1795578,308791,328451,19660,16.4,117,1
10,1852580,98047,168504,70457,7.8,118,1
11,2159587,279336,298617,19281,14.6,119,1
12,2022711,-119082,40152,159234,10.6,119,0
13,1893440,-142973,55242,198215,8.1,118,-1
14,1503436,-142996,25897,168893,12.4,117,-1
15,2880709,518842,561065,42223,17.9,118,1
16,2481098,395204,436458,41254,12.6,118,0
17,2481098,395204,436458,41254,7.7,118,0
18,1152597,-1245393,98217,1343610,0.0,119,1
19,927562,-233128,1056,234184,0.0,118,-1
20,870921,-59146,941,60087,0.0,118,0
21,833635,-37874,696,38570,0.0,118,0
22,803416,-30375,1018,31393,0.0,118,0
23,803416,-30375,1018,31393,1.4,118,0
24,863397,55717,71318,15601,5.7,118,0
25,997513,123058,148553,25495,9.6,118,0
0,28676,-502,2022,2524,2.1,50,0
1,42615,7191,12556,5365,0.0,50,0
2,38156,-5411,2200,7611,0.0,50,0
3,34380,-5594,1052,6646,0.0,50,0
4,32933,-2587,1244,3831,0.0,49,-1
5,31388,-2334,842,3176,0.0,49,0
6,29738,-2075,611,2686,0.0,49,0
7,29191,-1243,640,1883,0.0,48,-1
8,29101,-536,695,1231,5.0,48,0
9,35643,5046,6245,1199,2.4,48,0
10,41103,5194,6878,1684,1.6,48,0
11,117623,72435,74129,1694,0.0,48,0
12,110702,-4389,9569,13958,2.8,48,0
13,255236,133471,139430,5959,2.3,49,1
14,358637,32874,55815,22941,1.2,49,0
15,844806,187885,217815,29930,2.2,50,1
16,812840,241088,266041,24953,11.5,50,0
17,812840,241088,266041,24953,5.1,50,0
18,1433407,623359,647302,23943,2.3,51,1
19,1639857,206844,246560,39716,0.0,52,1
20,1613832,-27333,69806,97139,1.7,52,0
21,1613676,-8667,79078,87745,2.5,52,0
22,1779044,152224,223674,71450,2.6,52,0
23,1779044,152224,223674,71450,0.0,52,0
24,1810714,25195,98885,73690,2.2,52,0
25,1879314,62302,144406,82104,7.6,52,0
0,121294,-5287,4856,10143,2.7,60,0
1,130092,-1754,9921,11675,2.3,60,0
2,124430,-10029,3502,13531,0.1,60,0
3,121074,-8466,3220,11686,0.0,60,0
4,97846,-23118,595,23713,0.0,60,0
5,86926,-11869,179,12048,0.0,59,-1
6,81038,-6146,75,6221,0.0,59,0
7,77229,-4020,151,4171,0.0,59,0
8,77813,1,1329,1328,7.0,59,0
9,159976,65741,69283,3542,0.8,59,0
10,157288,7634,19555,11921,0.0,59,0
11,163919,3113,17943,14830,1.7,59,0
12,154988,-9564,6608,16172,0.0,59,0
13,147420,-9467,14530,23997,0.0,59,0
14,125622,-10198,1807,12005,0.0,59,0
15,122564,-5071,5789,10860,0.0,59,0
16,115845,-6497,887,7384,0.0,59,0
17,115845,-6497,887,7384,0.0,59,0
18,110878,-6427,1370,7797,0.0,59,0
19,107494,-3755,410,4165,0.0,59,0
20,105663,-2195,427,2622,0.0,59,0
21,103887,-2169,471,2640,0.0,59,0
22,102440,-1977,689,2666,0.0,59,0
23,102440,-1977,689,2666,0.0,59,0
24,101308,-1527,463,1990,0.0,59,0
25,100391,-1379,395,1774,0.0,59,0
0,151442,19355,43778,24423,0.0,85,0
1,125375,-31344,20978,52322,12.5,85,0
2,374253,220611,253434,32823,3.8,85,0
3,309895,-65148,70506,135654,9.3,85,0
4,284854,-29027,36043,65070,11.8,85,0
5,247155,-41126,18923,60049,5.5,84,-1
6,200715,-47567,8729,56296,0.0,83,-1
7,166412,-37388,8099,45487,7.8,82,-1
8,178758,7246,24398,17152,29.5,82,0
9,766741,520898,532082,11184,9.7,84,1
10,664337,-39500,113826,153326,4.1,84,0
11,800296,121883,195542,73659,0.0,84,0
12,652938,-143955,39959,183914,1.4,84,0
13,497052,-160171,39576,199747,0.0,83,-1
14,319413,-82629,8782,91411,0.1,82,-1
15,317914,-19410,36888,56298,5.7,81,-1
16,272796,-29133,14713,43846,0.0,81,0
17,272796,-29133,14713,43846,2.9,81,0
18,253865,-25681,21841,47522,14.2,81,0
19,293909,37592,50743,13151,0.0,81,0
20,304805,10161,39731,29570,5.7,81,0
21,262538,-42625,7533,50158,1.4,81,0
22,249827,-14641,19181,33822,1.5,81,0
23,249827,-14641,19181,33822,9.0,81,0
24,234268,-16485,8142,24627,9.6,81,0
25,262761,25516,41507,15991,7.2,81,0
0,322864,70648,106804,36156,6.6,115,0
1,431789,92242,158435,66193,5.1,115,0
2,496951,54283,108435,54152,16.7,115,0
3,436941,-54119,91739,145858,9.5,115,0
4,557608,100619,138478,37859,3.5,116,1
5,541559,-15902,43987,59889,8.2,116,0
6,463779,-75608,13479,89087,3.8,116,0
7,344145,-116904,13113,130017,1.8,115,-1
8,365304,5480,40427,34947,0.0,115,0
9,305795,-55736,15975,71711,12.4,114,-1
10,298936,-9147,17531,26678,3.8,114,0
11,340830,34544,48439,13895,18.2,114,0
12,323173,-13309,16361,29670,7.1,114,0
13,346580,16739,41683,24944,12.8,114,0
14,320067,-13889,23908,37797,4.2,114,0
15,382374,22473,80506,58033,2.4,114,0
16,336494,-8383,33191,41574,8.5,114,0
17,336494,-8383,33191,41574,7.1,114,0
18,761115,417851,452070,34219,18.1,115,1
19,999753,235631,261966,26335,0.0,116,1
20,945944,-50535,64223,114758,15.4,116,0
21,913499,-34244,58476,92720,12.2,116,0
22,1211408,254636,295126,40490,11.8,116,0
23,1211408,254636,295126,40490,3.0,116,0
24,1018956,-153553,22705,176258,14.2,116,0
25,962115,-58272,80053,138325,0.0,116,0
0,64092,-392,6014,6406,0.0,55,0
1,45106,-20635,3709,24344,0.0,55,0
2,34491,-11691,106,11797,0.0,54,-1
3,32560,-3042,861,3903,7.2,54,0
4,46332,10483,12850,2367,7.0,54,0
5,84710,33459,36825,3366,9.3,54,0
6,117349,28353,38663,10310,5.0,54,0
7,207222,79973,94565,14592,7.5,55,1
8,354361,131592,143976,12384,0.0,55,0
9,282774,-54669,20969,75638,4.0,55,0
10,276597,-11314,12425,23739,3.4,55,0
11,318251,36155,44469,8314,8.2,55,0
12,313374,-3609,16852,20461,4.1,55,0
13,463790,139667,152518,12851,6.2,56,1
14,587286,38373,84198,45825,5.1,57,1
15,1370771,274855,322616,47761,7.0,58,1
16,1044525,163826,206680,42854,0.6,58,0
17,1044525,163826,206680,42854,6.8,58,0
18,1050579,22985,118946,95961,15.3,58,0
19,1619460,549148,558762,9614,0.0,60,1
20,1663998,48856,114630,65774,4.9,60,0
21,1683799,13278,87449,74171,1.9,60,0
22,1841605,140346,208919,68573,6.0,61,1
23,1841605,140346,208919,68573,5.4,61,0
24,1961475,114002,158539,44537,3.9,61,0
25,2160702,179714,234140,54426,0.0,61,0
0,354253,9469,29834,20365,0.5,60,0
1,383518,1381,33928,32547,1.4,60,0
2,362349,-28151,10040,38191,4.3,60,0
3,401820,19235,47576,28341,2.9,60,0
4,441355,26158,40606,14448,0.8,60,0
5,436301,-9003,11971,20974,0.9,60,0
6,428011,-10694,8004,18698,2.2,60,0
7,421178,-11509,7660,19169,0.2,60,0
8,432941,1671,17852,16181,1.2,60,0
9,471360,28387,40431,12044,1.2,60,0
10,453521,-8801,11082,19883,1.6,60,0
11,481759,19446,27231,7785,1.2,60,0
12,464565,-13927,5741,19668,2.2,60,0
13,469401,-769,13186,13955,1.7,60,0
14,445752,-21034,10512,31546,0.0,60,0
15,485559,-13979,44652,58631,0.9,60,0
16,543376,74840,93032,18192,0.2,60,0
17,543376,74840,93032,18192,2.0,60,0
18,574910,53725,75023,21298,1.4,60,0
19,623718,44317,61202,16885,0.8,60,0
20,658384,30369,42057,11688,0.2,60,0
21,673300,9403,43237,33834,1.9,61,1
22,711425,27847,65020,37173,4.8,61,0
23,711425,27847,65020,37173,1.2,61,0
24,742803,25426,43317,17891,0.9,61,0
25,821250,64772,89619,24847,1.6,61,0
0,474483,4175,43491,39316,0.8,55,0
1,544619,33398,87670,54272,6.8,55,0
2,572796,7538,47177,39639,1.7,55,0
3,516579,-63361,18625,81986,1.5,55,0
4,515764,-9968,40944,50912,0.0,55,0
5,434208,-81984,1497,83481,0.0,55,0
6,402753,-35586,5308,40894,0.0,55,0
7,343316,-58909,2620,61529,0.0,55,0
8,291417,-55057,93,55150,0.0,54,-1
9,276957,-16333,1487,17820,0.0,54,0
10,267396,-10802,978,11780,0.0,54,0
11,260953,-7137,985,8122,2.0,54,0
12,258180,-3347,1588,4935,0.0,54,0
13,250057,-8552,1829,10381,3.8,54,0
14,250779,-2402,1930,4332,0.0,54,0
15,236190,-12856,1416,14272,0.0,54,0
16,229633,-8596,38,8634,0.0,54,0
17,229633,-8596,38,8634,0.0,54,0
18,218788,-11265,65,11330,0.0,54,0
19,214719,-4312,36,4348,0.0,54,0
20,211236,-3537,36,3573,0.0,54,0
21,207045,-4158,42,4200,0.0,54,0
22,202761,-4318,48,4366,0.0,54,0
23,202761,-4318,48,4366,0.0,54,0
24,200253,-2650,39,2689,0.0,54,0
25,197955,-2302,38,2340,0.0,54,0
0,302527,-27389,24063,51452,0.0,60,0
1,212908,-88900,1943,90843,0.0,60,0
2,207518,-15958,5388,21346,1.8,60,0
3,217028,-756,12571,13327,0.0,60,0
4,187709,-28209,3381,31590,0.0,60,0
5,189224,-2703,9433,12136,3.6,60,0
6,197644,4893,9047,4154,1.1,60,0
7,209184,6134,12472,6338,3.2,60,0
8,231660,17057,22702,5645,0.0,60,0
9,229353,-2522,12310,14832,0.0,60,0
10,212913,-17503,3316,20819,0.0,60,0
11,204978,-9780,2919,12699,0.0,60,0
12,196230,-9821,1584,11405,0.0,60,0
13,191126,-6958,8767,15725,0.0,60,0
14,190513,-2458,3129,5587,0.0,60,0
15,177767,-12568,2980,15548,0.0,60,0
16,172497,-6688,48,6736,0.0,60,0
17,172497,-6688,48,6736,0.0,60,0
18,168498,-4916,1648,6564,1.0,60,0
19,169000,-340,1737,2077,5.2,60,0
20,172323,2426,3735,1309,2.0,60,0
21,174766,1300,3261,1961,0.0,60,0
22,176541,220,5071,4851,1.2,60,0
23,176541,220,5071,4851,2.1,60,0
24,179333,1522,4073,2551,0.0,60,0
25,177910,-2581,2477,5058,0.0,60,0
0,43760,-10501,1947,12448,0.0,75,0
1,30180,-14252,977,15229,0.0,75,0
2,29186,-2824,3079,5903,2.3,74,-1
3,37354,4166,8642,4476,2.8,74,0
4,44862,5715,10187,4472,1.1,74,0
5,44531,-1213,5173,6386,3.7,74,0
6,42783,-2463,2876,5339,1.0,74,0
7,40706,-3246,1813,5059,1.7,74,0
8,44198,2424,5162,2738,0.0,74,0
9,42374,-2368,3111,5479,0.0,74,0
10,39323,-3467,1233,4700,0.0,74,0
11,40011,249,2644,2395,0.0,74,0
12,38743,-1494,1277,2771,7.2,74,0
13,40228,741,2953,2212,2.6,74,0
14,40691,-495,1309,1804,10.2,74,0
15,59225,7887,11480,3593,5.5,74,0
16,52230,2540,5922,3382,1.0,74,0
17,52230,2540,5922,3382,11.7,74,0
18,80125,26067,32875,6808,5.7,74,0
19,79293,-820,8972,9792,7.1,74,0
20,76333,-3501,5372,8873,5.5,74,0
21,76084,-1038,6244,7282,4.8,74,0
22,89893,11692,19983,8291,3.4,74,0
23,89893,11692,19983,8291,13.5,74,0
24,97893,7243,18281,11038,3.3,74,0
25,123438,23026,37820,14794,0.0,74,0
0,153900,29514,45431,15917,10.6,95,0
1,151721,-14146,74643,88789,0.0,95,0
2,75463,-75534,988,76522,0.0,94,-1
3,61917,-16611,493,17104,0.0,94,0
4,56383,-6119,211,6330,0.0,93,-1
5,53446,-3214,169,3383,0.0,93,0
6,59961,5108,6986,1878,6.9,93,0
7,85996,20495,26778,6283,7.9,93,0
8,111244,21196,29643,8447,5.7,93,0
9,234699,105167,115353,10186,3.4,94,1
10,146037,-68288,6659,74947,3.4,93,-1
11,166983,13256,30298,17042,4.8,93,0
12,129197,-34660,4970,39630,0.0,92,-1
13,83167,-46137,3104,49241,0.0,91,-1
14,69528,-4883,131,5014,0.0,91,0
15,121669,24341,30322,5981,0.4,91,0
16,109790,13192,24289,11097,6.5,91,0
17,109790,13192,24289,11097,2.9,91,0
18,171356,60037,75695,15658,2.3,91,0
19,191419,19519,51970,32451,10.9,91,0
20,289705,94446,106264,11818,10.3,92,1
21,333956,42018,66594,24576,3.0,92,0
22,434483,87710,141284,53574,5.3,92,0
23,434483,87710,141284,53574,9.8,92,0
24,345766,-78780,16318,95098,1.6,92,0
25,287167,-59116,23636,82752,0.1,92,0
0,30075,-1277,1417,2694,0.0,55,0
1,23043,-7889,1004,8893,0.0,55,0
2,19999,-3822,203,4025,0.0,55,0
3,16778,-3354,50,3404,0.0,55,0
4,16380,-747,342,1089,0.2,55,0
5,17235,326,884,558,0.0,55,0
6,16986,-487,456,943,0.0,55,0
7,17087,-297,450,747,0.0,55,0
8,16938,-339,264,603,0.0,55,0
9,16829,-324,327,651,0.0,55,0
10,16525,-410,134,544,0.0,55,0
11,16201,-402,68,470,0.0,55,0
12,15669,-538,12,550,0.0,55,0
13,15542,-227,252,479,0.0,55,0
14,15656,-36,157,193,2.5,55,0
15,21782,2661,3619,958,4.8,55,0
16,23121,3572,4530,958,1.7,55,0
17,23121,3572,4530,958,1.0,55,0
18,26060,2958,4655,1697,4.1,55,0
19,29667,3363,4854,1491,4.2,55,0
20,36749,6090,7413,1323,0.6,55,0
21,34369,-2577,2125,4702,1.9,55,0
22,42763,7290,10351,3061,3.8,55,0
23,42763,7290,10351,3061,0.0,55,0
24,46117,2899,5908,3009,6.7,55,0
25,57380,9867,13583,3716,4.9,55,0
0,279640,20071,59741,39670,8.8,65,0
1,529454,205051,284995,79944,0.4,65,0
2,603199,66213,135460,69247,7.6,66,1
3,521154,-84461,52017,136478,8.1,66,0
4,574478,39242,87799,48557,7.2,66,0
5,696537,110593,141792,31199,0.5,66,0
6,565085,-123496,22991,146487,0.0,66,0
7,464089,-103700,17396,121096,0.4,65,-1
8,450370,-23943,38580,62523,5.1,65,0
9,424292,-26010,32157,58167,0.0,65,0
10,350089,-75434,7682,83116,0.0,64,-1
11,341302,-11461,26919,38380,6.2,64,0
12,307747,-34396,7842,42238,0.0,63,-1
13,280598,-28199,11098,39297,0.0,63,0
14,247180,-18954,3763,22717,12.9,62,-1
15,548509,147152,177291,30139,12.8,62,0
16,867685,418897,451057,32160,1.5,63,1
17,867685,418897,451057,32160,20.1,63,0
18,947253,125090,229469,104379,8.0,63,0
19,771869,-173618,43298,216916,4.6,63,0
20,691448,-84107,24717,108824,0.0,62,-1
21,539991,-152979,10367,163346,11.3,61,-1
22,838017,272948,302932,29984,9.2,61,0
23,838017,272948,302932,29984,11.0,61,0
24,865821,37701,107840,70139,0.0,61,0
25,845106,-21677,107452,129129,2.3,61,0
0,6803,-145,709,854,0.0,45,0
1,7281,-226,943,1169,0.0,45,0
2,7152,-398,442,840,0.0,45,0
3,6677,-610,222,832,0.0,45,0
4,6508,-307,219,526,0.0,45,0
5,7222,346,824,478,0.0,44,-1
6,7373,16,601,585,0.0,44,0
7,7817,166,893,727,0.0,44,0
8,7574,-237,300,537,0.0,44,0
9,7383,-265,222,487,0.0,44,0
10,7395,-76,262,338,0.0,44,0
11,7278,-139,128,267,0.0,44,0
12,7394,48,314,266,0.0,44,0
13,7272,-209,217,426,0.0,44,0
14,7116,-161,98,259,0.0,44,0
15,6624,-411,64,475,0.0,44,0
16,6486,-245,20,265,0.0,44,0
17,6486,-245,20,265,0.0,44,0
18,6386,-165,107,272,0.0,44,0
19,6274,-132,50,182,0.0,44,0
20,6196,-106,47,153,0.0,44,0
21,6115,-95,43,138,0.0,44,0
22,6028,-109,74,183,0.0,44,0
23,6028,-109,74,183,0.0,44,0
24,5957,-97,42,139,0.0,44,0
25,5904,-79,52,131,0.0,44,0
0,37251,-1071,3748,4819,2.9,55,0
1,36118,-3393,3472,6865,2.4,55,0
2,37249,-974,3853,4827,2.7,55,0
3,35663,-3143,2464,5607,3.6,55,0
4,35264,-1453,1982,3435,5.8,54,-1
5,34789,-1186,1811,2997,2.8,54,0
6,34456,-846,1895,2741,0.4,54,0
7,34918,-340,2462,2802,10.1,54,0
8,37461,1838,3888,2050,1.0,54,0
9,35958,-1626,1912,3538,5.5,54,0
10,35168,-1157,1335,2492,3.8,54,0
11,37046,1527,2964,1437,6.0,54,0
12,36175,-1007,1110,2117,2.2,54,0
13,36573,-82,2049,2131,2.2,54,0
14,34609,-1078,891,1969,6.8,54,0
15,35580,36,2463,2427,2.9,54,0
16,35231,-12,1170,1182,0.0,54,0
17,35231,-12,1170,1182,14.5,54,0
18,35179,-434,1522,1956,1.9,54,0
19,34256,-1038,660,1698,0.0,53,-1
20,33555,-843,457,1300,4.4,53,0
21,32866,-860,348,1208,2.8,53,0
22,32037,-939,1026,1965,8.9,53,0
23,32037,-939,1026,1965,6.2,53,0
24,33570,1129,2086,957,0.0,53,0
25,33983,186,1989,1803,0.0,53,0
0,79393,-2600,8008,10608,0.0,70,0
1,68207,-12411,2916,15327,1.3,70,0
2,62847,-7005,2704,9709,6.9,69,-1
3,62459,-2055,4543,6598,0.0,69,0
4,59304,-3535,2552,6087,0.0,69,0
5,60702,493,5745,5252,9.5,69,0
6,67299,5540,9962,4422,0.2,69,0
7,87968,17479,24164,6685,11.6,69,0
8,120034,30249,38802,8553,7.1,69,0
9,163703,41577,52595,11018,0.0,69,0
10,127289,-32732,7401,40133,0.5,69,0
11,152196,22207,38543,16336,0.0,69,0
12,122398,-29268,5323,34591,0.4,69,0
13,111519,-11926,8570,20496,7.8,69,0
14,117090,-5134,9553,14687,0.0,69,0
15,85560,-22614,5079,27693,0.0,69,0
16,85608,-9689,1980,11669,0.3,69,0
17,85608,-9689,1980,11669,0.0,69,0
18,81376,-5622,2707,8329,3.7,69,0
19,75197,-6371,808,7179,7.2,69,0
20,75266,-261,2236,2497,0.0,69,0
21,71627,-3747,694,4441,0.0,69,0
22,68491,-3299,1093,4392,0.4,69,0
23,68491,-3299,1093,4392,0.0,69,0
24,66420,-2363,433,2796,0.0,69,0
25,64912,-1652,526,2178,3.8,69,0
0,19182,-783,1500,2283,0.0,50,0
1,16149,-4026,1074,5100,3.0,49,-1
2,16980,-569,1687,2256,0.0,49,0
3,14933,-2566,559,3125,0.0,48,-1
4,15323,-266,1050,1316,3.0,48,0
5,16792,719,1624,905,0.0,48,0
6,15906,-1032,566,1598,0.0,48,0
7,15733,-608,601,1209,0.0,48,0
8,15601,-389,438,827,0.0,48,0
9,15413,-374,422,796,0.0,48,0
10,14728,-800,196,996,0.0,48,0
11,13719,-1007,15,1022,0.0,48,0
12,13134,-623,23,646,0.0,48,0
13,12513,-623,17,640,0.0,48,0
14,12088,-228,38,266,0.0,47,-1
15,11852,-264,91,355,0.0,47,0
16,11777,-97,42,139,0.0,47,0
17,11777,-97,42,139,0.0,47,0
18,11937,24,245,221,0.0,47,0
19,12092,49,228,179,0.0,47,0
20,12188,1,167,166,0.0,47,0
21,12287,-20,208,228,0.0,47,0
22,12432,-32,260,292,0.0,47,0
23,12432,-32,260,292,0.0,47,0
24,12508,-52,227,279,0.0,47,0
25,12523,-104,181,285,0.0,47,0
0,0,0,0,0,0.0,45,0
1,366,158,259,101,0.0,45,0
2,300,-62,48,110,0.0,45,0
3,293,-30,51,81,0.0,45,0
4,349,18,87,69,0.0,45,0
5,485,58,105,47,0.0,45,0
6,595,29,92,63,0.0,45,0
7,728,25,119,94,0.0,45,0
8,802,15,78,63,0.0,45,0
9,820,-32,46,78,0.0,45,0
10,844,-18,39,57,0.0,45,0
11,846,-14,33,47,0.0,45,0
12,875,5,44,39,0.0,45,0
13,923,-10,55,65,0.0,45,0
14,941,-12,28,40,0.0,45,0
15,1032,-7,62,69,0.0,45,0
16,936,-58,9,67,0.0,45,0
17,936,-58,9,67,0.0,45,0
18,940,-22,39,61,0.0,45,0
19,942,-20,24,44,0.0,45,0
20,944,-13,17,30,0.0,45,0
21,956,-8,16,24,0.0,45,0
22,987,-6,31,37,0.0,45,0
23,987,-6,31,37,0.0,45,0
24,980,-27,26,53,0.0,45,0
25,974,-19,18,37,0.0,45,0
0,0,0,0,0,0.0,45,0
1,431,105,136,31,0.0,45,0
2,892,54,120,66,0.0,45,0
3,1324,2,154,152,0.0,45,0
4,1519,-27,105,132,0.0,45,0
5,1692,-27,83,110,0.0,45,0
6,1776,-44,53,97,0.0,45,0
7,1868,-48,62,110,0.0,45,0
8,1903,-45,29,74,0.0,45,0
9,1962,-47,42,89,0.0,45,0
10,2029,-24,53,77,0.0,45,0
11,2069,-17,31,48,0.0,45,0
12,2121,-8,35,43,0.0,45,0
13,2232,-2,60,62,0.0,45,0
14,2918,589,783,194,1.0,44,-1
15,51256,12940,20183,7243,0.0,44,0
16,10001,-4871,823,5694,0.0,44,0
17,10001,-4871,823,5694,0.0,44,0
18,8419,-2646,396,3042,0.0,44,0
19,7309,-1235,157,1392,0.0,44,0
20,6865,-523,136,659,0.0,44,0
21,6532,-448,180,628,0.0,44,0
22,5851,-735,202,937,0.0,44,0
23,5851,-735,202,937,0.0,44,0
24,5758,-261,147,408,0.0,44,0
25,5444,-377,184,561,0.0,44,0
0,0,0,0,0,0.0,45,0
1,32011,22979,29701,6722,0.2,45,0
2,71732,28634,49221,20587,0.0,45,0
3,69304,-3278,17767,21045,0.0,45,0
4,74604,1746,14720,12974,0.0,45,0
5,69943,-5069,6476,11545,0.0,44,-1
6,66204,-4244,5047,9291,0.0,44,0
7,67498,-1180,9173,10353,0.0,44,0
8,68123,217,6529,6312,0.0,44,0
9,74099,3955,11508,7553,0.0,44,0
10,79812,5410,13139,7729,0.0,44,0
11,82317,1941,8376,6435,0.0,44,0
12,82914,171,6394,6223,0.0,44,0
13,84812,721,8903,8182,0.0,44,0
14,83048,-1187,6100,7287,0.0,44,0
15,94166,887,13402,12515,0.0,44,0
16,93375,4314,13542,9228,0.0,44,0
17,93375,4314,13542,9228,0.0,44,0
18,85771,-4022,8428,12450,0.0,44,0
19,81656,-4377,4103,8480,0.0,44,0
20,80020,-2045,4295,6340,0.0,44,0
21,76802,-3473,2533,6006,0.0,44,0
22,75873,-1408,7881,9289,0.0,43,-1
23,75873,-1408,7881,9289,0.0,43,0
24,78896,2067,9057,6990,0.0,43,0
25,81413,1037,11371,10334,0.0,43,0
0,0,0,0,0,0.0,45,0
1,416,201,270,69,0.0,45,0
2,642,56,190,134,0.0,45,0
3,792,38,153,115,0.0,45,0
4,855,-9,82,91,0.0,45,0
5,888,-27,64,91,0.0,45,0
6,974,-1,97,98,0.0,45,0
7,1003,-29,58,87,0.0,45,0
8,987,-39,40,79,0.0,45,0
9,999,-19,40,59,0.0,45,0
10,1012,-16,30,46,0.0,45,0
11,1038,2,33,31,0.0,45,0
12,1050,-23,43,66,0.0,45,0
13,1078,6,44,38,0.0,44,-1
14,1128,-22,114,136,0.0,44,0
15,1085,-18,28,46,0.0,44,0
16,1085,-18,28,46,0.0,44,0
17,1057,-37,39,76,0.0,44,0
18,1042,-16,30,46,0.0,44,0
19,1019,-26,31,57,0.0,44,0
20,1045,21,65,44,0.0,44,0
21,1090,1,82,81,0.0,44,0
22,1090,1,82,81,0.0,44,0
23,1119,7,57,50,0.0,44,0
24,1159,13,76,63,0.0,44,0
0,7762,6169,7019,850,2.8,55,0
1,39139,24210,30281,6071,1.8,55,0
2,95913,50505,56079,5574,2.6,55,0
3,119212,21735,29272,7537,1.6,55,0
4,125470,5997,16288,10291,1.8,55,0
5,145213,15602,26083,10481,5.3,55,0
6,185849,34295,44884,10589,2.2,55,0
7,248265,55514,64375,8861,3.0,56,1
8,247154,6417,20702,14285,1.4,56,0
9,322238,67661,72958,5297,5.0,56,0
10,311749,-7120,15844,22964,2.2,56,0
11,489796,163139,175133,11994,2.4,57,1
12,548141,10239,52415,42176,4.4,57,0
13,946169,157268,202276,45008,2.9,58,1
14,891459,154332,186853,32521,5.0,58,0
15,891459,154332,186853,32521,6.2,58,0
16,1206458,320265,351891,31626,2.1,59,1
17,1302119,94881,140084,45203,3.1,59,0
18,1553531,237705,252571,14866,1.3,60,1
19,1722554,158317,196687,38370,1.5,61,1
20,1675281,-42526,158422,200948,0.0,61,0
21,1675281,-42526,158422,200948,3.4,61,0
22,1664833,-30590,59606,90196,2.4,61,0
23,1791947,107962,157799,49837,7.3,61,0
0,0,0,0,0,0.0,40,0
1,1664,953,1073,120,0.0,40,0
2,3988,1481,1961,480,0.0,40,0
3,4336,472,988,516,0.0,40,0
4,5127,448,944,496,0.0,40,0
5,6002,706,1039,333,0.0,40,0
6,6133,100,500,400,0.0,40,0
7,6818,495,798,303,0.0,40,0
8,7408,282,801,519,0.0,40,0
9,8096,263,747,484,0.0,40,0
10,13114,363,1550,1187,0.0,40,0
11,8687,-129,573,702,0.0,40,0
12,8687,-129,573,702,0.0,40,0
13,8478,-308,448,756,0.0,40,0
14,8126,-415,169,584,0.0,40,0
15,8088,-125,200,325,0.0,40,0
16,7976,-199,192,391,0.0,40,0
17,7404,-598,184,782,0.0,40,0
18,7404,-598,184,782,0.0,40,0
19,7175,-359,97,456,0.0,40,0
20,6784,-443,111,554,0.0,40,0
0,0,0,0,0,0.0,40,0
1,1040,689,757,68,0.0,40,0
2,2190,626,839,213,0.0,40,0
3,2892,234,899,665,0.0,40,0
4,2229,-233,73,306,0.0,40,0
5,2229,-233,73,306,0.0,40,0
6,2098,-168,97,265,0.0,40,0
7,1952,-160,50,210,0.0,40,0
8,1905,-59,57,116,0.0,40,0
9,1999,25,146,121,0.0,40,0
10,1962,-60,211,271,0.0,40,0
11,1962,-60,211,271,0.0,40,0
12,5393,2789,3395,606,0.0,39,-1
13,9897,3197,5162,1965,0.0,39,0
0,0,0,0,0,0.0,45,0
1,59,22,31,9,0.0,45,0
2,88,1,19,18,0.0,45,0
3,206,18,47,29,0.0,45,0
4,176,5,28,23,0.0,45,0
5,176,5,28,23,0.0,45,0
6,201,3,28,25,0.0,45,0
7,213,-7,13,20,0.0,45,0
8,226,4,19,15,0.0,45,0
9,241,1,21,20,0.0,45,0
10,236,-19,18,37,0.0,45,0
11,236,-19,18,37,0.0,45,0
12,248,-4,22,26,0.0,45,0
13,273,6,23,17,0.0,45,0
0,0,0,0,0,0.0,40,0
1,661,137,189,52,0.0,40,0
2,437,31,88,57,0.0,40,0
3,437,31,88,57,0.0,40,0
4,652,34,118,84,0.0,40,0
5,698,-18,58,76,0.0,40,0
6,797,10,66,56,0.0,40,0
7,970,47,122,75,0.0,40,0
8,1173,44,201,157,0.0,40,0
9,1173,44,201,157,0.0,40,0
10,1275,-14,119,133,0.0,40,0
11,1404,-23,122,145,0.0,40,0
0,0,0,0,0,0.0,45,0
1,52,28,35,7,0.0,45,0
2,153,40,73,33,0.0,45,0
3,153,40,73,33,0.0,45,0
4,206,19,54,35,0.0,45,0
5,261,5,50,45,0.0,45,0
0,8726,-391,641,1032,0.0,60,0
1,8065,-1553,361,1914,0.0,60,0
2,8183,-649,611,1260,0.0,59,-1
3,8292,-680,529,1209,9.5,59,0
4,10093,937,1741,804,5.9,59,0
5,10652,91,1069,978,0.0,59,0
6,10212,-696,433,1129,1.7,59,0
7,11217,321,1265,944,2.6,59,0
8,11995,480,1149,669,0.0,59,0
9,11411,-760,490,1250,3.4,59,0
10,11865,84,745,661,0.0,59,0
11,11728,-279,424,703,2.4,59,0
12,11571,-287,252,539,0.0,59,0
13,11180,-621,249,870,0.0,59,0
14,11013,-254,104,358,0.0,59,0
15,10885,-241,137,378,0.0,58,-1
16,10923,-259,253,512,0.0,58,0
17,10810,-111,100,211,0.0,58,0
18,10810,-111,100,211,0.0,58,0
19,10655,-282,71,353,0.0,58,0
20,10569,-153,35,188,0.0,58,0
21,10530,-109,57,166,0.0,58,0
22,10473,-143,48,191,0.0,58,0
23,10453,-122,75,197,0.0,58,0
24,10497,-69,68,137,0.1,58,0
25,10497,-104,93,197,0.0,58,0
0,296170,8554,24934,16380,1.7,55,0
1,297884,-17027,18294,35321,2.6,55,0
2,282198,-23850,5325,29175,2.0,55,0
3,275436,-18230,11854,30084,2.7,55,0
4,274878,-7559,8189,15748,0.9,55,0
5,281089,-1008,7541,8549,0.6,54,-1
6,277812,-6041,5141,11182,0.2,54,0
7,302780,7985,19898,11913,2.0,54,0
8,291830,-3651,6019,9670,0.4,54,0
9,270309,-22383,4309,26692,0.0,54,0
10,256611,-15897,1590,17487,2.0,54,0
11,265828,4889,8997,4108,0.0,53,-1
12,256997,-8051,2207,10258,1.9,53,0
13,253039,-6514,3091,9605,1.0,53,0
14,250038,-4217,2045,6262,3.4,53,0
15,262195,9480,14447,4967,3.0,53,0
16,535004,86228,108459,22231,0.1,53,0
17,366906,12095,32135,20040,2.2,53,0
18,366906,12095,32135,20040,3.1,53,0
19,406165,32770,47887,15117,1.1,53,0
20,390295,-15428,6258,21686,2.3,53,0
21,395552,2458,10758,8300,0.6,53,0
22,414011,13746,26118,12372,0.0,53,0
23,399591,-15843,12013,27856,2.1,53,0
24,396287,-7407,8080,15487,2.4,53,0
25,379733,-16874,5244,22118,3.2,53,0
0,18715,-198,2081,2279,0.0,50,0
1,16713,-3205,1197,4402,3.6,50,0
2,20209,1359,3481,2122,1.7,50,0
3,19226,-1799,1488,3287,0.2,50,0
4,18331,-1413,735,2148,0.0,49,-1
5,17264,-1372,426,1798,3.3,49,0
6,16699,-795,405,1200,0.0,49,0
7,16227,-831,567,1398,3.4,48,-1
8,16514,23,681,658,2.5,48,0
9,16675,-83,796,879,0.0,48,0
10,16313,-506,451,957,0.0,48,0
11,16113,-326,302,628,0.6,48,0
12,16014,-200,285,485,0.0,48,0
13,15886,-303,523,826,0.0,48,0
14,15625,-327,136,463,4.2,48,0
15,15680,-61,372,433,1.3,48,0
16,16117,-137,676,813,2.6,48,0
17,15695,-121,446,567,0.0,48,0
18,15695,-121,446,567,0.2,48,0
19,15349,-443,217,660,2.5,47,-1
20,15285,-152,184,336,0.0,47,0
21,15132,-213,131,344,0.0,47,0
22,14918,-276,98,374,0.0,47,0
23,14729,-275,122,397,0.0,47,0
24,14683,-141,94,235,7.5,47,0
25,14843,56,303,247,0.0,47,0
0,141119,15876,31510,15634,3.8,80,0
1,122029,-27439,9465,36904,0.0,80,0
2,112089,-16993,7625,24618,1.6,79,-1
3,103769,-14759,6031,20790,1.9,79,0
4,100931,-5800,6039,11839,3.1,78,-1
5,99359,-4025,5431,9456,2.1,78,0
6,95066,-5547,3371,8918,0.1,78,0
7,91489,-5983,2972,8955,0.0,77,-1
8,83405,-8277,312,8589,0.0,77,0
9,79586,-4396,711,5107,7.2,77,0
10,86574,5281,7535,2254,5.3,77,0
11,96330,8725,11159,2434,3.1,77,0
12,107630,10392,13874,3482,0.0,77,0
13,102295,-6426,6799,13225,0.5,77,0
14,99754,-3557,3069,6626,4.5,77,0
15,100097,-669,4629,5298,9.5,77,0
16,104556,1799,10911,9112,10.4,77,0
17,143304,31239,37614,6375,7.5,77,0
18,143304,31239,37614,6375,7.6,77,0
19,275170,128954,147645,18691,4.1,77,0
20,237227,-35595,16634,52229,4.4,77,0
21,225469,-14693,16369,31062,0.0,77,0
22,196468,-30894,9467,40361,0.9,77,0
23,125058,-70531,1395,71926,0.0,76,-1
24,110406,-17045,128,17173,0.0,76,0
25,102808,-7824,119,7943,0.0,76,0
0,276468,11004,28710,17706,2.3,55,0
1,259603,-28042,17781,45823,3.4,55,0
2,240877,-26765,8706,35471,0.3,55,0
3,202383,-41565,4057,45622,8.6,54,-1
4,201421,-5327,10741,16068,5.2,54,0
5,224646,16904,23411,6507,5.3,54,0
6,224806,-1129,11175,12304,2.7,54,0
7,237839,6124,25507,19383,5.6,54,0
8,248818,9835,16761,6926,3.1,54,0
9,254510,3117,14329,11212,3.5,54,0
10,243088,-11663,4626,16289,2.9,54,0
11,267152,17158,22491,5333,1.9,54,0
12,259731,-4541,7890,12431,6.6,54,0
13,257206,-4876,12309,17185,1.3,54,0
14,263878,4605,14821,10216,2.8,54,0
15,296370,29831,39273,9442,3.4,54,0
16,412199,33459,60254,26795,1.9,54,0
17,338143,4060,22028,17968,4.4,54,0
18,338143,4060,22028,17968,4.3,54,0
19,382285,38441,53348,14907,7.6,54,0
20,384746,1704,20177,18473,4.4,54,0
21,427992,39224,47167,7943,2.0,55,1
22,439923,8688,25983,17295,2.9,55,0
23,433274,-8390,21470,29860,5.6,55,0
24,433588,-4312,15233,19545,9.1,55,0
25,437207,466,22104,21638,2.2,55,0
0,11306,-623,935,1558,0.0,55,0
1,9885,-2240,497,2737,0.3,54,-1
2,9571,-874,494,1368,1.0,54,0
3,9023,-940,319,1259,3.5,54,0
4,9369,-16,632,648,1.7,53,-1
5,10665,753,1450,697,0.5,53,0
6,11202,194,1212,1018,4.0,53,0
7,12992,979,2219,1240,4.0,53,0
8,13820,538,1486,948,5.5,53,0
9,14392,156,1613,1457,0.0,53,0
10,13881,-757,783,1540,2.8,53,0
11,14992,756,1434,678,0.0,53,0
12,14684,-458,650,1108,6.5,53,0
13,15938,660,1880,1220,3.2,53,0
14,16153,-3,834,837,0.0,53,0
15,15961,-408,781,1189,1.1,53,0
16,17346,233,1894,1661,0.0,53,0
17,16208,-530,371,901,3.3,53,0
18,16208,-530,371,901,6.0,53,0
19,16278,-263,873,1136,0.0,53,0
20,15763,-632,212,844,4.4,53,0
21,15821,-114,431,545,6.1,53,0
22,15596,-385,366,751,2.1,53,0
23,15361,-428,448,876,2.8,53,0
24,15310,-224,354,578,4.3,53,0
25,15812,205,808,603,3.3,53,0
0,111268,20945,36929,15984,2.3,50,0
1,113514,-3434,17662,21096,2.1,50,0
2,99298,-15258,4090,19348,2.8,50,0
3,82452,-18656,3015,21671,5.7,49,-1
4,73392,-10383,1879,12262,2.1,49,0
5,74981,-161,4326,4487,5.3,49,0
6,74208,-1684,3896,5580,5.5,49,0
7,56876,-16643,2030,18673,0.0,48,-1
8,50063,-7724,86,7810,0.0,48,0
9,44859,-5290,54,5344,0.0,48,0
10,44054,-1346,533,1879,4.8,48,0
11,60756,14515,15509,994,0.0,48,0
12,57939,-1687,3012,4699,4.9,48,0
13,57334,-1311,4041,5352,5.7,48,0
14,64791,6555,8848,2293,3.8,48,0
15,71722,6430,11229,4799,7.4,48,0
16,160712,28091,44399,16308,5.5,48,0
17,132332,26688,39168,12480,5.9,48,0
18,132332,26688,39168,12480,7.8,48,0
19,217237,84532,98362,13830,2.7,48,0
20,215929,-1309,19638,20947,7.4,48,0
21,254631,36027,41724,5697,12.7,48,0
22,435769,174083,181265,7182,6.4,49,1
23,552019,109654,129095,19441,10.9,50,1
24,710730,152331,164191,11860,9.7,50,0
25,848394,124247,162508,38261,6.4,51,1
0,1623046,451998,525858,73860,12.9,105,0
1,1344788,-274258,80386,354644,12.0,105,0
2,1473422,76237,187021,110784,7.5,105,0
3,1508759,-1258,192662,193920,22.0,105,0
4,1609144,85046,163779,78733,9.6,105,0
5,1601697,-17677,68832,86509,3.5,105,0
6,1495550,-108368,38692,147060,17.3,105,0
7,2644080,1033358,1055501,22143,20.1,107,1
8,2832510,241785,298414,56629,11.0,108,1
9,3103036,242451,283987,41536,12.2,109,1
10,3049874,-32910,124346,157256,8.2,109,0
11,3258678,173773,211622,37849,2.4,110,1
12,3248370,-5647,83501,89148,18.5,110,0
13,3359878,88219,201910,113691,14.6,110,0
14,3644822,264327,276147,11820,13.6,111,1
15,3869250,213222,229413,16191,15.5,112,1
16,4398545,271408,294187,22779,9.2,113,1
17,4139736,-12831,91675,104506,7.9,113,0
18,4139736,-12831,91675,104506,7.4,113,0
19,4491956,315163,348430,33267,9.4,113,0
20,4435441,-57421,75425,132846,4.1,114,1
21,4465306,16203,93203,77000,22.4,114,0
22,4675676,187847,200383,12536,10.8,115,1
23,4774932,79908,110716,30808,9.3,115,0
24,4834223,41622,63513,21891,13.3,116,1
25,4871297,19376,82355,62979,4.6,116,0
0,1156211,340570,419865,79295,3.5,90,0
1,929457,-221548,59278,280826,3.3,90,0
2,655400,-290358,12984,303342,0.8,89,-1
3,343479,-317561,3756,321317,0.0,88,-1
4,290691,-64934,568,65502,0.0,88,0
5,268070,-25060,527,25587,0.0,88,0
6,281400,9759,18854,9095,1.0,87,-1
7,304974,15553,29906,14353,10.7,87,0
8,288089,-12731,4938,17669,0.0,87,0
9,271415,-17430,4258,21688,3.2,87,0
10,255207,-16915,1125,18040,1.4,87,0
11,258385,1261,6013,4752,16.2,87,0
12,275075,15661,19209,3548,14.2,87,0
13,307199,28601,37958,9357,3.5,87,0
14,320948,13404,28539,15135,1.4,87,0
15,337430,15060,33602,18542,11.2,87,0
16,651853,162249,201346,39097,9.3,88,1
17,440382,-48361,46766,95127,2.3,88,0
18,440382,-48361,46766,95127,3.9,88,0
19,454965,3238,55800,52562,3.8,88,0
20,406683,-48727,12748,61475,6.1,88,0
21,384474,-23748,13973,37721,15.4,87,-1
22,442966,54024,69915,15891,0.0,87,0
23,385484,-56284,18646,74930,1.4,87,0
24,365331,-23530,11340,34870,4.4,87,0
25,342864,-23043,11434,34477,0.5,87,0
0,182213,-18567,3240,21807,0.0,55,0
1,158237,-30830,2112,32942,0.0,55,0
2,144099,-18987,908,19895,0.0,54,-1
3,136461,-12142,1793,13935,0.0,54,0
4,129776,-8250,501,8751,0.0,54,0
5,124680,-6192,165,6357,0.0,53,-1
6,120556,-4750,173,4923,0.0,53,0
7,116848,-4571,233,4804,0.0,53,0
8,114603,-2750,127,2877,1.3,53,0
9,115746,18,3314,3296,2.6,53,0
10,115753,-885,1420,2305,0.0,53,0
11,114039,-2051,228,2279,2.6,53,0
12,113050,-1358,256,1614,0.0,53,0
13,111210,-2377,236,2613,0.0,52,-1
14,110380,-1233,158,1391,0.0,52,0
15,109294,-1447,139,1586,0.0,52,0
16,108213,-1986,564,2550,0.0,52,0
17,107231,-942,140,1082,0.0,52,0
18,107231,-942,140,1082,0.0,52,0
19,106447,-1404,270,1674,0.0,52,0
20,106076,-640,125,765,0.0,52,0
21,105665,-670,91,761,0.0,52,0
22,104878,-1109,190,1299,0.0,52,0
23,104246,-1098,248,1346,0.0,52,0
24,103837,-802,150,952,0.0,52,0
25,103425,-852,131,983,0.0,52,0
0,445991,111651,160201,48550,5.0,95,0
1,380669,-71554,46907,118461,9.0,95,0
2,445218,46715,98467,51752,2.3,95,0
3,417457,-42366,66781,109147,22.3,95,0
4,513232,82732,117223,34491,6.2,95,0
5,642682,117364,151365,34001,3.7,95,0
6,672502,26468,90351,63883,10.9,96,1
7,556688,-111225,42929,154154,5.9,96,0
8,528919,-37712,33294,71006,10.4,95,-1
9,440895,-84742,14070,98812,9.5,95,0
10,461068,9343,43693,34350,1.8,94,-1
11,538525,66787,89095,22308,13.2,94,0
12,688683,148472,164363,15891,7.9,95,1
13,674404,-13944,79248,93192,9.2,95,0
14,654312,-21854,49057,70911,8.1,95,0
15,796276,132085,164720,32635,6.7,95,0
16,1276859,144807,228843,84036,5.8,96,1
17,1016925,52232,138917,86685,1.5,96,0
18,1016925,52232,138917,86685,0.6,96,0
19,979575,-22285,154682,176967,3.6,96,0
20,866131,-115240,36800,152040,2.4,96,0
21,839491,-31382,59440,90822,9.5,95,-1
22,972545,124855,153453,28598,10.1,96,1
23,1008588,33134,103522,70388,6.0,96,0
24,953612,-57795,33513,91308,9.6,96,0
25,988575,26583,103952,77369,6.6,96,0
0,1726,-627,51,678,0.0,45,0
1,1475,-304,32,336,0.0,45,0
2,1342,-144,30,174,0.0,45,0
3,1308,-74,61,135,0.0,45,0
4,8840,6432,7039,607,0.0,45,0
5,9778,830,2566,1736,0.0,45,0
6,8918,-1025,651,1676,0.7,45,0
7,9840,292,1711,1419,0.0,44,-1
8,9102,-714,469,1183,0.0,44,0
9,8218,-970,255,1225,0.0,43,-1
10,7937,-474,326,800,0.0,43,0
11,7636,-385,158,543,0.0,43,0
12,7407,-299,193,492,0.0,42,-1
13,7704,135,710,575,0.0,42,0
14,8633,766,1228,462,0.0,42,0
15,8381,-268,580,848,0.0,42,0
16,10719,244,1482,1238,0.0,42,0
17,8532,-348,400,748,0.0,42,0
18,8532,-348,400,748,0.0,42,0
19,8004,-625,306,931,2.9,42,0
20,7925,-167,310,477,0.0,42,0
21,7877,-110,228,338,0.0,42,0
22,7528,-418,180,598,0.0,42,0
23,7378,-253,331,584,0.0,42,0
24,7353,-115,170,285,0.0,42,0
25,7324,-141,197,338,0.0,42,0
0,128704,834,12555,11721,2.5,50,0
1,115282,-16933,5627,22560,2.7,50,0
2,102580,-14917,2190,17107,0.0,49,-1
3,91743,-12897,2621,15518,1.3,49,0
4,88879,-4519,2967,7486,3.2,49,0
5,93619,2633,6232,3599,1.9,49,0
6,91572,-2652,3349,6001,1.1,49,0
7,88620,-3918,5722,9640,2.9,49,0
8,89210,-147,4150,4297,1.4,49,0
9,92336,1552,5579,4027,2.2,48,-1
10,91004,-1513,3307,4820,2.8,48,0
11,109071,15167,17236,2069,4.9,48,0
12,115029,6930,10880,3950,8.1,48,0
13,145399,26281,32552,6271,0.9,48,0
14,123007,-20740,2203,22943,0.0,48,0
15,105888,-17672,1419,19091,0.0,48,0
16,141098,5505,20929,15424,0.0,48,0
17,92476,-17803,528,18331,2.3,48,0
18,92476,-17803,528,18331,0.0,48,0
19,93543,-2073,4381,6454,0.0,48,0
20,90654,-3171,1126,4297,1.9,48,0
21,92257,1150,2562,1412,3.1,48,0
22,94597,1755,3978,2223,2.6,48,0
23,95278,251,3732,3481,1.6,48,0
24,97156,1042,3944,2902,1.1,48,0
25,100816,2700,7136,4436,1.3,48,0
0,21842,-813,1846,2659,9.1,50,0
1,23212,-674,3326,4000,0.0,50,0
2,20570,-3179,1034,4213,1.5,50,0
3,19116,-2286,1114,3400,5.8,49,-1
4,19684,-126,1594,1720,2.4,49,0
5,20883,603,2090,1487,2.8,49,0
6,20980,-209,1533,1742,2.9,49,0
7,23209,1214,3430,2216,0.2,49,0
8,21987,-1264,844,2108,0.0,49,0
9,19649,-2422,448,2870,2.3,49,0
10,19898,-169,913,1082,1.6,49,0
11,21048,889,1600,711,0.2,49,0
12,20719,-415,660,1075,15.8,49,0
13,42334,19873,23506,3633,2.5,49,0
14,61356,17587,21604,4017,0.0,49,0
15,69928,8167,17884,9717,1.0,49,0
16,139567,31595,49986,18391,0.7,49,0
17,107408,2863,21257,18394,2.1,49,0
18,107408,2863,21257,18394,0.0,49,0
19,96260,-10632,9646,20278,0.0,49,0
20,76512,-19989,1404,21393,0.4,49,0
21,63691,-13167,773,13940,7.5,49,0
22,64282,-396,4333,4729,6.8,49,0
23,78179,12188,17609,5421,7.6,49,0
24,73715,-4992,4575,9567,0.0,49,0
25,60887,-12591,1442,14033,5.3,49,0
0,18413,-432,1385,1817,0.0,50,0
1,20150,-758,3237,3995,0.1,50,0
2,20485,-1157,1599,2756,2.4,50,0
3,20194,-1613,1453,3066,0.0,50,0
4,17499,-2918,334,3252,0.0,49,-1
5,15175,-2486,45,2531,0.0,49,0
6,13908,-1345,26,1371,0.0,49,0
7,13002,-959,49,1008,0.0,49,0
8,12663,-398,37,435,0.0,49,0
9,12566,-192,110,302,0.0,49,0
10,12713,-74,160,234,0.0,49,0
11,12810,-49,135,184,0.0,49,0
12,12897,-57,129,186,0.0,49,0
13,13179,-3,346,349,1.5,49,0
14,14740,1314,1562,248,3.3,49,0
15,23891,8533,9641,1108,1.9,49,0
16,38193,11280,22607,11327,2.8,49,0
17,54784,15464,20266,4802,0.0,49,0
18,54784,15464,20266,4802,3.2,49,0
19,48673,-3914,5232,9146,0.0,49,0
20,39170,-9587,592,10179,0.0,49,0
21,35450,-4138,655,4793,0.0,49,0
22,28558,-7080,350,7430,0.0,49,0
23,24592,-4002,137,4139,0.0,49,0
24,24268,-752,412,1164,0.0,48,-1
25,23600,-947,476,1423,0.0,48,0
0,26990,-652,2827,3479,2.9,65,0
1,24494,-4407,1582,5989,0.0,65,0
2,21384,-4112,702,4814,0.0,64,-1
3,19581,-2818,628,3446,9.2,64,0
4,19108,-986,475,1461,2.1,63,-1
5,18727,-731,375,1106,0.0,63,0
6,18054,-875,284,1159,0.0,63,0
7,17722,-683,396,1079,0.0,63,0
8,17668,-253,349,602,0.0,63,0
9,17450,-423,279,702,0.0,62,-1
10,17291,-356,259,615,0.0,62,0
11,17308,-130,247,377,0.0,62,0
12,17230,-178,179,357,9.5,62,0
13,18623,965,1521,556,0.0,62,0
14,18742,20,557,537,0.0,62,0
15,18634,-226,476,702,2.5,62,0
16,19056,-206,695,901,0.0,62,0
17,18483,-309,177,486,0.0,62,0
18,18483,-309,177,486,0.0,62,0
19,18212,-454,220,674,0.0,62,0
20,18020,-257,77,334,0.0,62,0
21,17869,-221,59,280,9.1,62,0
22,17955,-29,251,280,0.0,62,0
23,17817,-248,161,409,0.0,62,0
24,17856,-91,188,279,8.5,62,0
25,19216,1021,1900,879,2.2,62,0
0,865810,59156,118395,59239,0.0,55,0
1,759590,-123785,34697,158482,1.7,55,0
2,668279,-106230,9167,115397,3.2,54,-1
3,584766,-94333,10097,104430,11.8,54,0
4,606360,6338,34222,27884,2.1,54,0
5,650958,32323,47820,15497,1.1,54,0
6,646278,-7702,23417,31119,1.3,54,0
7,698777,27252,58258,31006,3.4,54,0
8,655146,-29575,16942,46517,3.5,54,0
9,654648,-7909,20350,28259,4.3,54,0
10,631254,-25100,8782,33882,2.2,54,0
11,665611,24179,34384,10205,2.1,54,0
12,650952,-11740,11590,23330,3.5,54,0
13,584362,-66098,6572,72670,0.0,54,0
14,542510,-44196,648,44844,1.6,54,0
15,557599,11330,27750,16420,7.2,53,-1
16,1068633,179792,217150,37358,3.6,53,0
17,760075,19541,53484,33943,2.3,54,1
18,760075,19541,53484,33943,5.0,54,0
19,814560,47753,75270,27517,6.8,54,0
20,780782,-33749,13524,47273,6.2,54,0
21,826337,40041,51121,11080,8.9,54,0
22,1150782,308219,318729,10510,6.8,55,1
23,1347558,179288,211580,32292,3.6,56,1
24,1394962,44957,92090,47133,0.9,56,0
25,1417512,14774,96413,81639,2.8,56,0
0,558286,60421,132089,71668,2.8,75,0
1,473066,-95807,61932,157739,2.4,75,0
2,421310,-60881,28824,89705,2.2,74,-1
3,350098,-79062,22151,101213,0.0,73,-1
4,245135,-103865,1434,105299,2.2,73,0
5,226694,-23931,6333,30264,2.5,72,-1
6,213491,-14505,5988,20493,0.0,72,0
7,176280,-36559,1099,37658,0.0,71,-1
8,168107,-10078,1780,11858,1.4,71,0
9,162244,-6701,2239,8940,8.7,71,0
10,167104,3772,7537,3765,2.0,71,0
11,184747,16770,20318,3548,4.3,71,0
12,184641,-27,7602,7629,0.0,71,0
13,171555,-13380,3426,16806,0.0,71,0
14,165722,-6680,2196,8876,4.5,71,0
15,163127,-3093,3813,6906,0.0,71,0
16,158382,-5605,3582,9187,0.1,71,0
17,153315,-4859,661,5520,0.0,70,-1
18,153315,-4859,661,5520,2.5,70,0
19,153408,-1095,4137,5232,5.5,70,0
20,150329,-3382,905,4287,0.1,70,0
21,148903,-1809,934,2743,11.9,70,0
22,149120,-254,2198,2452,3.0,70,0
23,150251,432,3800,3368,4.9,70,0
24,149997,-819,2174,2993,1.9,70,0
25,150507,-257,3247,3504,1.9,70,0
0,112113,-4225,7969,12194,0.0,45,0
1,94186,-20057,2812,22869,0.0,45,0
2,82734,-13545,1604,15149,0.0,44,-1
3,73725,-10194,1348,11542,0.0,44,0
4,68037,-6392,791,7183,0.0,44,0
5,64457,-4161,739,4900,0.0,43,-1
6,61212,-3436,605,4041,0.0,43,0
7,58219,-3304,1058,4362,0.0,43,0
8,56595,-1991,459,2450,0.1,43,0
9,55594,-1376,1007,2383,0.0,42,-1
10,55420,-526,1519,2045,0.0,42,0
11,54925,-665,967,1632,0.0,42,0
12,54046,-1007,545,1552,0.0,42,0
13,52934,-1311,901,2212,0.0,42,0
14,52032,-1034,399,1433,0.0,42,0
15,50852,-1305,327,1632,0.0,42,0
16,49143,-1648,651,2299,0.0,42,0
17,47789,-1524,128,1652,0.0,42,0
18,47789,-1524,128,1652,0.0,42,0
19,44990,-2929,32,2961,0.0,42,0
20,43797,-1275,21,1296,0.0,42,0
21,43041,-811,60,871,0.0,42,0
22,42462,-669,158,827,0.0,42,0
23,41905,-661,196,857,0.0,42,0
24,41686,-352,164,516,0.0,42,0
25,41329,-484,174,658,0.0,42,0
0,247988,23767,51212,27445,6.3,70,0
1,308691,27384,72384,45000,0.2,70,0
2,249660,-60916,11478,72394,0.9,70,0
3,207093,-49922,9351,59273,1.5,69,-1
4,183400,-27208,4019,31227,0.0,69,0
5,162321,-23132,2058,25190,1.3,68,-1
6,149345,-14044,1459,15503,0.0,68,0
7,137728,-12766,2013,14779,0.3,67,-1
8,134348,-4259,1923,6182,3.0,67,0
9,133134,-2125,2923,5048,0.4,67,0
10,129051,-4393,1117,5510,0.0,67,0
11,127187,-2262,1413,3675,0.0,67,0
12,124747,-2649,773,3422,2.3,67,0
13,121786,-3376,1046,4422,0.0,66,-1
14,120225,-1794,324,2118,0.0,66,0
15,118615,-1827,440,2267,0.0,66,0
16,116663,-2569,953,3522,0.0,66,0
17,115422,-1151,220,1371,0.0,66,0
18,115422,-1151,220,1371,0.0,66,0
19,113797,-1903,329,2232,1.3,66,0
20,112987,-971,130,1101,0.0,66,0
21,112270,-840,146,986,0.4,66,0
22,111232,-1201,214,1415,0.0,66,0
23,110377,-1074,283,1357,0.6,66,0
24,109385,-1121,100,1221,0.0,66,0
25,108058,-1340,29,1369,0.0,66,0
0,62121,50001,57981,7980,0.0,55,0
1,87906,25878,35811,9933,0.0,55,0
2,67127,-20025,11760,31785,0.0,55,0
3,51625,-15942,1136,17078,0.0,55,0
4,97096,36105,43517,7412,2.0,55,0
5,130818,34928,39651,4723,6.4,55,0
6,135893,5439,19724,14285,5.7,55,0
7,139318,2422,14832,12410,0.0,55,0
8,125416,-15169,5444,20613,4.6,55,0
9,118180,-7966,4280,12246,5.7,55,0
10,106369,-12851,6195,19046,0.0,55,0
11,96043,-11304,2747,14051,0.9,55,0
12,87725,-9133,3627,12760,0.0,55,0
13,84970,-7948,7665,15613,0.0,55,0
14,71557,-9521,879,10400,0.0,55,0
15,71557,-9521,879,10400,0.0,55,0
16,62741,-10336,1295,11631,6.6,55,0
17,60396,-2828,963,3791,0.0,55,0
18,57511,-3131,605,3736,0.0,55,0
19,51867,-5850,393,6243,0.0,55,0
20,48651,-3583,528,4111,0.0,54,-1
21,47419,-1614,461,2075,0.0,54,0
22,45757,-1916,319,2235,0.0,54,0
0,27586,24237,40011,15774,0.0,80,0
1,35601,7765,14726,6961,2.4,80,0
2,50645,12008,18871,6863,0.0,80,0
3,41676,-9536,5831,15367,5.6,80,0
4,63515,15967,24413,8446,3.9,80,0
5,48624,-13551,3568,17119,16.2,80,0
6,274902,201055,210304,9249,0.0,81,1
7,146089,-108648,9631,118279,0.0,80,-1
8,109219,-40656,2293,42949,0.0,80,0
9,81511,-28653,1161,29814,3.3,79,-1
10,80278,-3778,10835,14613,3.4,78,-1
11,107749,24475,29452,4977,1.5,78,0
12,82802,-24652,11919,36571,0.0,78,0
13,158336,35443,55253,19810,7.3,78,0
14,221262,89570,107271,17701,0.3,78,0
15,221262,89570,107271,17701,7.8,78,0
16,333650,115840,147512,31672,0.7,78,0
17,325761,-7717,47419,55136,2.7,79,1
18,355853,26757,59153,32396,5.9,79,0
19,300214,-55322,21722,77044,11.5,79,0
20,518756,196720,219327,22607,0.8,80,1
21,394604,-109669,26932,136601,0.0,80,0
22,226853,-164450,3268,167718,0.0,79,-1
0,0,0,0,0,0.0,40,0
1,1904,1404,1540,136,0.0,40,0
2,1914,1,575,574,0.0,40,0
3,2320,307,524,217,0.0,40,0
4,3682,957,1203,246,0.0,40,0
5,3933,249,547,298,0.0,40,0
6,4302,288,765,477,0.0,40,0
7,9589,357,1113,756,0.0,40,0
8,5317,86,533,447,0.0,40,0
9,5317,86,533,447,0.0,40,0
10,4974,-129,379,508,0.0,40,0
11,5082,37,251,214,0.0,40,0
12,5144,5,218,213,0.0,40,0
13,4946,-259,147,406,0.0,40,0
14,4780,-228,165,393,0.0,40,0
15,4766,-91,139,230,0.0,40,0
16,4806,-50,280,330,0.0,40,0
0,706,644,753,109,0.0,55,0
1,720,-7,196,203,0.0,55,0
2,785,37,204,167,0.0,55,0
3,726,-120,136,256,0.0,55,0
4,783,-18,188,206,0.0,55,0
5,821,-13,129,142,0.0,54,-1
6,938,43,229,186,0.0,54,0
0,0,0,0,0,0.1,45,0
1,118,87,112,25,0.0,45,0
0,7504,0,0,0,0.0,50,0
1,6935,-1555,261,1816,0.0,50,0
2,6446,-943,528,1471,0.0,49,-1
3,6061,-637,277,914,0.0,49,0
4,5732,-562,288,850,0.0,48,-1
5,5819,-130,389,519,0.0,48,0
6,5778,-163,251,414,0.0,48,0
7,5707,-184,292,476,0.0,48,0
8,5783,-126,314,440,0.7,48,0
9,5891,20,293,273,4.1,48,0
10,5837,-110,215,325,0.0,48,0
11,5797,-111,176,287,0.0,48,0
12,5759,-84,116,200,0.1,48,0
13,5677,-116,94,210,2.7,48,0
14,5739,-22,249,271,2.1,47,-1
15,5754,-27,165,192,0.0,47,0
16,5698,-97,139,236,0.4,47,0
17,5839,-68,288,356,0.0,47,0
18,5654,-98,76,174,0.0,47,0
19,5589,-122,160,282,0.0,47,0
20,5434,-150,45,85,0.0,47,0
21,5695,245,280,35,0.0,47,0
22,5896,158,353,195,9.9,47,0
23,8186,2121,2599,478,3.2,47,0
24,8171,11,625,614,1.1,47,0
0,21822,0,0,0,6.9,55,0
1,56622,18447,30119,11672,0.6,55,0
2,45386,-11267,4646,15913,2.3,55,0
3,41322,-6319,2812,9131,0.0,55,0
4,34424,-7691,2129,9820,0.0,54,-1
5,31398,-3865,1606,5471,0.0,54,0
6,28684,-3103,790,3893,0.2,53,-1
7,27116,-1880,758,2638,0.3,53,0
8,25811,-1610,912,2522,2.2,53,0
9,24873,-1137,772,1909,0.0,52,-1
10,21601,-1189,165,1354,0.0,52,0
11,21514,-199,415,614,0.0,52,0
12,21356,-221,381,602,0.0,52,0
13,20976,-498,471,969,0.7,52,0
14,20827,-218,192,410,0.0,52,0
15,20697,-220,295,515,8.2,52,0
16,49567,10627,14511,3884,0.1,52,0
17,33584,1031,5233,4202,1.8,52,0
18,33584,1031,5233,4202,0.2,52,0
19,31221,-1810,2545,4355,0.0,52,0
20,29097,-2216,894,3110,0.0,52,0
21,27380,-1837,846,2683,3.6,52,0
22,26029,-1460,475,1935,0.0,52,0
23,25030,-1069,824,1893,0.0,52,0
24,24780,-429,795,1224,0.0,52,0
0,20721,0,0,0,8.1,55,0
1,23268,-606,2154,2760,3.2,55,0
2,20570,-3465,804,4269,2.8,55,0
3,20794,-757,1814,2571,3.6,55,0
4,19149,-2081,917,2998,5.0,54,-1
5,18116,-1308,512,1820,0.0,54,0
6,14233,-3886,103,3989,0.0,54,0
7,12038,-2292,46,2338,0.0,53,-1
8,10756,-1299,36,1335,0.0,53,0
9,10882,-18,257,275,5.9,53,0
10,11004,171,472,301,6.0,53,0
11,11089,65,355,290,0.0,53,0
12,11039,-111,283,394,3.8,53,0
13,10831,-262,210,472,0.0,53,0
14,10493,-347,28,375,0.0,53,0
15,10276,-249,52,301,0.5,53,0
16,11238,226,635,409,0.0,53,0
17,10322,-257,72,329,2.6,53,0
18,10322,-257,72,329,4.3,53,0
19,10235,-170,147,317,10.1,53,0
20,10114,-131,106,237,3.8,53,0
21,10355,185,372,187,7.4,53,0
22,11060,609,917,308,0.8,53,0
23,10419,-675,166,841,5.0,53,0
24,10411,-64,198,262,1.3,53,0
0,7154,0,0,0,0.0,50,0
1,7463,-511,570,1081,0.0,50,0
2,6774,-1062,394,1456,5.3,50,0
3,5384,-1442,137,1579,0.0,50,0
4,4385,-1040,44,1084,0.0,49,-1
5,3546,-879,34,913,0.0,49,0
6,3298,-258,18,276,0.0,49,0
7,3130,-173,20,193,0.0,49,0
8,2983,-146,38,184,0.0,49,0
9,3027,9,112,103,3.2,49,0
10,3115,44,132,88,5.6,49,0
11,3333,195,270,75,0.0,49,0
12,3322,-21,151,172,6.3,49,0
13,3324,-33,137,170,0.3,49,0
14,3286,-49,52,101,5.4,49,0
15,3422,95,217,122,5.6,49,0
16,6720,846,1440,594,0.2,49,0
17,4034,-282,217,499,0.0,49,0
18,4034,-282,217,499,0.0,49,0
19,3816,-279,97,376,0.0,49,0
20,3568,-257,15,272,0.0,49,0
21,3469,-125,21,146,0.0,49,0
22,3388,-101,18,119,0.0,49,0
23,3334,-76,24,100,0.0,49,0
24,3333,-15,61,76,0.0,49,0
0,88657,0,0,0,2.8,50,0
1,102812,487,9576,9089,1.0,50,0
2,88610,-15084,2860,17944,3.8,50,0
3,89113,-3290,5526,8816,2.7,50,0
4,82472,-7617,3198,10815,2.7,50,0
5,75073,-7959,1078,9037,1.9,50,0
6,72134,-3843,1212,5055,4.4,49,-1
7,71215,-1757,2512,4269,2.1,49,0
8,65007,-6144,1060,7204,1.0,49,0
9,63676,-2310,2452,4762,1.7,49,0
10,62960,1812,5005,3193,0.0,48,-1
11,58530,-3886,700,4586,1.9,48,0
12,58929,-69,2966,3035,1.7,48,0
13,50256,-8413,160,8573,2.3,48,0
14,49106,-1478,511,1989,2.9,47,-1
15,51869,2464,4092,1628,3.4,47,0
16,238159,37930,49509,11579,3.7,47,0
17,69609,-17002,2015,19017,0.0,47,0
18,69609,-17002,2015,19017,0.0,47,0
19,57201,-15622,182,15804,0.0,47,0
20,50103,-7277,34,7311,0.0,47,0
21,45777,-4430,50,4480,0.0,47,0
22,42504,-3304,47,3351,0.0,47,0
23,40129,-2292,81,2373,0.0,47,0
24,39215,-1069,15,1084,0.0,47,0
0,3326,0,0,0,0.0,45,0
1,4113,-181,422,603,0.0,45,0
2,4317,-355,439,794,0.0,45,0
3,3456,-869,22,891,0.0,45,0
4,3016,-480,41,521,0.0,45,0
5,2834,-213,19,232,0.0,45,0
6,2704,-136,15,151,0.0,45,0
7,2786,-24,93,117,0.0,45,0
8,2862,-58,93,151,1.3,45,0
9,3073,96,212,116,1.8,45,0
10,4549,870,1162,292,3.8,45,0
11,4828,285,714,429,7.3,45,0
12,12040,6390,7162,772,1.5,45,0
13,9957,-1778,1845,3623,3.0,45,0
14,9915,-148,941,1089,4.3,45,0
15,11474,1381,2521,1140,2.2,45,0
16,150902,24881,33040,8159,3.0,45,0
17,30957,-4791,4506,9297,0.8,45,0
18,30957,-4791,4506,9297,0.0,45,0
19,23471,-8128,860,8988,0.0,45,0
20,17553,-5984,28,6012,0.8,45,0
21,16992,-743,529,1272,5.0,45,0
22,15010,-2057,249,2306,0.0,45,0
23,12679,-2201,129,2330,1.7,45,0
24,12397,-562,200,762,2.8,45,0
0,13715,0,0,0,2.7,50,0
1,33351,6661,11384,4723,1.8,50,0
2,31277,-3469,13018,16487,7.6,50,0
3,85192,34849,42714,7865,2.0,50,0
4,119216,23495,39368,15873,7.6,50,0
5,117415,-1032,14217,15249,1.8,50,0
6,123516,3022,10564,7542,2.4,50,0
7,136869,10038,16401,6363,3.1,50,0
8,132236,-4510,5988,10498,1.8,50,0
9,131310,-2818,5464,8282,2.3,50,0
10,146925,11947,17937,5990,1.0,50,0
11,138020,-6721,2589,9310,4.3,50,0
12,141758,1958,8808,6850,3.2,50,0
13,127233,-13974,1872,15846,3.1,50,0
14,121815,-6093,1065,7158,3.1,50,0
15,124621,1576,8328,6752,1.0,50,0
16,553863,79410,101820,22410,2.5,50,0
17,184078,-17920,13288,31208,2.8,50,0
18,184078,-17920,13288,31208,2.2,50,0
19,173120,-15214,4688,19902,1.1,50,0
20,161578,-11933,1358,13291,2.1,50,0
21,161798,-773,4459,5232,0.7,50,0
22,157413,-5087,4568,9655,2.5,50,0
23,142069,-14690,1581,16271,3.1,50,0
24,137600,-6122,903,7025,2.5,50,0
0,27245,0,0,0,0.0,50,0
1,22181,-5809,271,6080,0.0,50,0
2,18941,-3856,161,4017,0.0,50,0
3,17303,-1954,171,2125,0.0,49,-1
4,15903,-1606,230,1836,0.0,49,0
5,15081,-919,98,1017,0.0,49,0
6,14493,-652,48,700,0.0,49,0
7,13999,-533,64,597,0.0,49,0
8,13497,-518,88,606,0.0,49,0
9,13206,-338,67,405,0.0,49,0
10,12559,-238,34,272,0.0,49,0
11,12429,-154,35,189,0.0,49,0
12,12262,-175,25,200,0.0,49,0
13,12033,-224,38,262,0.0,48,-1
14,11959,-94,22,116,0.0,48,0
15,12078,54,232,178,0.0,48,0
16,34042,3304,4811,1507,0.0,48,0
17,15008,-741,852,1593,0.0,48,0
18,15008,-741,852,1593,0.0,48,0
19,14665,-566,419,985,0.0,48,0
20,14451,-318,149,467,0.0,48,0
21,14358,-198,221,419,0.0,48,0
22,14582,27,503,476,0.0,48,0
23,14518,-250,300,550,0.0,48,0
24,14554,-110,189,299,0.0,48,0
0,219489,0,0,0,2.2,45,0
1,265866,19303,40930,21627,1.3,45,0
2,231900,-33644,13383,47027,1.6,45,0
3,211899,-23380,7636,31016,0.0,45,0
4,167928,-42925,934,43859,2.6,45,0
5,159220,-11979,3817,15796,1.6,44,-1
6,149306,-10660,2334,12994,3.2,44,0
7,142965,-6813,2677,9490,2.1,44,0
8,133568,-9134,2248,11382,0.9,44,0
9,121597,-12205,257,12462,0.0,44,0
10,99764,-6639,492,7131,0.0,43,-1
11,93761,-6086,262,6348,0.0,43,0
12,85074,-8840,97,8937,0.0,43,0
13,74767,-10122,159,10281,0.0,43,0
14,69913,-5134,71,5205,0.0,43,0
15,65390,-4616,314,4930,0.0,42,-1
16,82204,1601,5736,4135,0.0,42,0
17,67358,-222,3350,3572,2.7,42,0
18,67358,-222,3350,3572,3.3,42,0
19,66683,-553,2504,3057,7.4,42,0
20,65557,-1159,1147,2306,0.9,42,0
21,60746,-4774,98,4872,0.0,42,0
22,57439,-3337,95,3432,0.0,42,0
23,54809,-2522,91,2613,2.8,42,0
24,54728,-315,501,816,0.6,42,0
0,3224,0,0,0,0.0,60,0
1,2498,-855,77,932,0.0,60,0
2,2098,-484,51,535,0.0,59,-1
3,1899,-245,35,280,0.0,59,0
4,1781,-150,67,217,0.0,59,0
5,1730,-65,42,107,0.0,59,0
6,1688,-52,29,81,0.0,59,0
7,1650,-46,28,74,0.0,59,0
8,1641,-20,50,70,0.0,59,0
9,1625,-21,42,63,0.0,59,0
10,1642,-6,30,36,10.7,59,0
11,2848,1005,1174,169,0.1,59,0
12,3007,172,558,386,0.3,59,0
13,2876,-218,346,564,0.0,59,0
14,2870,-40,202,242,0.0,59,0
15,2883,-38,284,322,0.0,59,0
16,5264,944,1668,724,0.0,59,0
17,3641,-305,335,640,0.0,59,0
18,3641,-305,335,640,0.2,59,0
19,3428,-289,343,632,0.1,59,0
20,3315,-140,125,265,0.0,59,0
21,3245,-96,248,344,0.1,59,0
22,3194,-102,191,293,0.0,59,0
23,3293,48,387,339,2.6,59,0
24,3496,146,416,270,0.1,59,0
0,2038,0,0,0,0.0,45,0
1,1643,-419,19,438,0.0,45,0
2,1364,-300,27,327,0.0,45,0
3,1231,-153,17,170,0.0,44,-1
4,1139,-104,20,124,0.0,44,0
5,1085,-62,8,70,0.0,44,0
6,1053,-42,11,53,0.0,44,0
7,1055,-15,21,36,0.0,44,0
8,1071,-20,39,59,0.0,44,0
9,1029,-42,10,52,0.0,44,0
10,971,-21,11,32,0.0,44,0
11,950,-20,10,30,0.0,44,0
12,939,-12,11,23,0.3,44,0
13,1044,63,97,34,0.0,44,0
14,1050,-12,31,43,0.0,44,0
15,1023,-31,6,37,0.0,44,0
16,2639,339,475,136,1.3,44,0
17,1537,70,215,145,0.0,44,0
18,1537,70,215,145,0.0,44,0
19,1404,-136,82,218,0.0,44,0
20,1293,-109,19,128,0.0,44,0
21,1281,-27,37,64,0.0,44,0
22,1342,27,73,46,1.4,44,0
23,1379,-3,85,88,0.0,44,0
24,1394,-13,52,65,0.0,44,0
0,21964,0,0,0,4.4,45,0
1,29716,2307,4953,2646,1.1,45,0
2,28698,-1988,2388,4376,0.9,45,0
3,31359,1018,3699,2681,1.6,45,0
4,29047,-2327,1636,3963,0.0,45,0
5,26586,-2733,346,3079,0.0,45,0
6,24405,-2466,130,2596,0.0,45,0
7,22159,-2312,128,2440,0.0,44,-1
8,20270,-1975,86,2061,1.6,44,0
9,20023,-486,323,809,3.2,44,0
10,21035,894,1738,844,0.0,44,0
11,19877,-1015,325,1340,0.0,44,0
12,19759,-271,792,1063,0.0,43,-1
13,19145,-721,768,1489,0.0,43,0
14,18613,-557,232,789,0.0,43,0
15,17945,-716,153,869,0.0,43,0
16,19974,-95,1015,1110,0.0,43,0
17,17338,-598,248,846,0.0,43,0
18,17338,-598,248,846,2.7,43,0
19,16625,-813,106,919,0.0,42,-1
20,16288,-373,123,496,1.3,42,0
21,16989,595,911,316,2.4,42,0
22,17198,159,779,620,0.9,42,0
23,15636,-1490,160,1650,0.0,42,0
24,14912,-802,52,854,0.0,42,0
0,5746,0,0,0,0.0,45,0
1,5689,-972,104,1076,0.0,45,0
2,5235,-806,104,910,0.0,44,-1
3,4807,-581,79,660,3.4,44,0
4,5018,-44,435,479,3.5,44,0
5,5293,133,501,368,0.0,44,0
6,5202,-144,165,309,0.0,44,0
7,4996,-257,58,315,0.0,44,0
8,4860,-220,111,331,0.0,43,-1
9,4792,-139,67,206,0.0,43,0
10,4582,-110,62,172,1.2,43,0
11,4806,155,271,116,1.3,43,0
12,4707,-81,111,192,0.0,43,0
13,4608,-156,66,222,0.0,43,0
14,4559,-73,30,103,0.0,43,0
15,4508,-84,43,127,0.0,43,0
16,5004,20,246,226,0.0,43,0
17,4487,-111,31,142,1.4,43,0
18,4487,-111,31,142,0.0,43,0
19,4515,-24,130,154,0.0,42,-1
20,4441,-89,36,125,0.0,42,0
21,4422,-45,41,86,0.0,42,0
22,4415,-29,66,95,2.0,42,0
23,4438,-23,110,133,0.8,42,0
24,4476,11,107,96,3.6,42,0
0,1810,0,0,0,0.0,50,0
1,1519,-480,50,530,0.0,50,0
2,1283,-323,52,375,0.0,49,-1
3,1608,107,309,202,0.3,49,0
4,2130,171,462,291,0.8,49,0
5,2555,156,435,279,1.8,49,0
6,3032,220,401,181,1.6,49,0
7,3594,290,548,258,1.7,49,0
8,3838,-6,396,402,0.4,49,0
9,4451,375,674,299,0.0,49,0
10,4810,377,749,372,0.0,49,0
11,4466,-312,208,520,0.0,49,0
12,4873,249,615,366,0.0,49,0
13,4487,-476,189,665,1.9,49,0
14,4470,-80,131,211,3.1,49,0
15,4934,343,611,268,1.8,49,0
16,24233,5141,7104,1963,3.6,49,0
17,8750,-1587,554,2141,0.0,49,0
18,8750,-1587,554,2141,1.7,49,0
19,8243,-772,811,1583,4.4,49,0
20,7152,-1130,189,1319,3.8,49,0
21,8781,1401,1895,494,3.7,49,0
22,8885,-29,1144,1173,1.8,49,0
23,6464,-2350,156,2506,0.0,49,0
24,5775,-787,15,802,0.0,49,0
0,5941,0,0,0,1.5,50,0
1,6488,-540,553,1093,2.8,50,0
2,5983,-843,408,1251,1.8,50,0
3,5980,-286,542,828,2.4,50,0
4,5605,-594,388,982,2.1,49,-1
5,4683,-919,46,965,0.0,49,0
6,4612,-181,217,398,0.0,48,-1
7,4545,-134,195,329,0.0,48,0
8,4406,-208,200,408,1.4,48,0
9,4441,-34,211,245,0.0,48,0
10,4117,-108,80,188,2.5,48,0
11,4125,-26,101,127,3.3,48,0
12,4116,-34,116,150,1.9,48,0
13,4119,-39,163,202,1.9,47,-1
14,4227,73,217,144,1.1,47,0
15,4062,-176,156,332,0.0,47,0
16,5899,255,665,410,3.7,47,0
17,4459,24,305,281,0.0,47,0
18,4459,24,305,281,1.9,47,0
19,4270,-175,116,291,2.5,47,0
20,4073,-214,48,262,4.7,47,0
21,4041,-60,91,151,1.7,47,0
22,3981,-78,80,158,1.3,47,0
23,3903,-106,73,179,5.5,47,0
24,3900,-38,64,102,0.7,46,-1
0,1361562,0,0,0,1.2,55,0
1,1348064,-83797,80068,163865,0.0,55,0
2,698170,-641093,12187,653280,0.0,54,-1
3,526681,-190292,4317,194609,12.1,54,0
4,520353,-20265,63152,83417,5.7,53,-1
5,519419,-6393,42070,48463,4.0,53,0
6,527223,3611,37771,34160,3.5,53,0
7,512662,-15930,27416,43346,1.6,53,0
8,458695,-51600,17288,68888,1.9,53,0
9,428811,-34227,17699,51926,0.0,53,0
10,298913,-35591,1344,36935,0.0,52,-1
11,276216,-23195,494,23689,0.0,52,0
12,256195,-20643,365,21008,0.0,51,-1
13,233585,-22256,460,22716,0.0,51,0
14,222550,-11685,97,11782,0.0,51,0
15,212055,-10704,197,10901,0.0,51,0
16,197226,-11560,292,11852,0.0,51,0
17,195641,-5066,217,5283,0.0,51,0
18,195641,-5066,217,5283,0.2,51,0
19,193407,-2929,1891,4820,2.4,51,0
20,191495,-2121,1137,3258,0.4,51,0
21,191749,29,2277,2248,4.3,51,0
22,189926,-1961,1098,3059,7.2,51,0
23,192500,2262,5318,3056,5.9,51,0
24,191350,-1427,1582,3009,9.2,51,0
0,62869,0,0,0,4.9,60,0
1,67366,-2812,8323,11135,6.0,60,0
2,51637,-16383,2697,19080,3.9,59,-1
3,49013,-4514,3467,7981,0.0,59,0
4,39213,-10011,805,10816,0.3,58,-1
5,34882,-4946,371,5317,5.6,58,0
6,32525,-2779,420,3199,2.0,57,-1
7,31182,-1598,634,2232,0.6,57,0
8,29551,-1829,669,2498,3.4,57,0
9,29446,-480,1177,1657,1.2,57,0
10,28273,246,1525,1279,11.0,56,-1
11,33258,4588,5607,1019,0.2,56,0
12,34903,1550,3947,2397,4.4,56,0
13,32169,-2763,1284,4047,4.5,56,0
14,31203,-1171,525,1696,0.8,56,0
15,30506,-849,895,1744,0.5,56,0
16,44226,4459,8174,3715,0.0,56,0
17,31644,-3356,602,3958,2.5,56,0
18,31644,-3356,602,3958,4.9,56,0
19,30471,-1666,917,2583,11.0,56,0
20,30013,-571,799,1370,7.7,56,0
21,30640,422,1687,1265,9.3,56,0
22,30520,-273,1506,1779,10.3,56,0
23,34190,3134,6031,2897,1.3,56,0
24,33833,-621,1989,2610,2.9,56,0
0,26389,0,0,0,2.6,60,0
1,24573,-4777,1618,6395,0.3,60,0
2,19628,-5887,844,6731,1.5,59,-1
3,18563,-2101,1302,3403,5.1,59,0
4,16897,-2118,823,2941,2.0,58,-1
5,16497,-801,656,1457,0.4,58,0
6,15624,-1077,295,1372,0.0,58,0
7,14866,-845,325,1170,2.0,57,-1
8,14396,-641,380,1021,3.0,57,0
9,14469,-85,541,626,13.6,57,0
10,32102,11027,13788,2761,8.5,57,0
11,43276,9861,12940,3079,1.8,57,0
12,49612,6037,11257,5220,3.0,57,0
13,42664,-6890,4985,11875,0.9,57,0
14,40060,-2959,1871,4830,3.5,57,0
15,37919,-2343,2301,4644,3.0,57,0
16,76253,14655,24401,9746,0.0,57,0
17,44593,-7514,3906,11420,1.4,57,0
18,44593,-7514,3906,11420,0.0,57,0
19,39124,-6479,1601,8080,0.0,57,0
20,34300,-4927,392,5319,0.0,57,0
21,31278,-3145,881,4026,0.0,57,0
22,28601,-2797,464,3261,0.9,57,0
23,27547,-1170,1389,2559,0.7,57,0
24,26921,-799,966,1765,7.2,57,0
0,7807,0,0,0,0.1,50,0
1,7922,-1099,311,1410,0.0,50,0
2,7117,-1150,365,1515,0.0,49,-1
3,6646,-720,262,982,0.0,49,0
4,6141,-657,197,854,0.0,48,-1
5,5945,-315,280,595,0.2,48,0
6,5792,-253,144,397,7.1,48,0
7,5739,-128,195,323,3.1,48,0
8,5580,-235,156,391,1.0,48,0
9,5755,73,329,256,2.0,48,0
10,6305,587,917,330,2.1,47,-1
11,6694,361,690,329,2.3,47,0
12,6718,18,378,360,5.1,47,0
13,7478,609,1177,568,0.0,47,0
14,7272,-197,217,414,0.0,47,0
15,7004,-301,242,543,1.8,47,0
16,9739,567,1408,841,0.5,47,0
17,7535,-175,404,579,0.0,47,0
18,7535,-175,404,579,0.0,47,0
19,6958,-587,113,700,0.0,47,0
20,6449,-536,15,551,0.0,47,0
21,6161,-311,18,329,0.0,47,0
22,5911,-259,16,275,0.0,47,0
23,5680,-251,23,274,0.0,47,0
24,5596,-112,27,139,0.0,47,0
0,6679,0,0,0,10.3,50,0
1,291284,181855,227467,45612,0.1,50,0
2,284007,-2484,76965,79449,0.5,50,0
3,354822,52512,98519,46007,0.7,51,1
4,289612,-58010,14187,72197,2.1,51,0
5,264943,-30080,11759,41839,2.1,50,-1
6,244934,-22602,7219,29821,1.7,50,0
7,227165,-19124,9744,28868,0.0,49,-1
8,209258,-17946,10225,28171,0.0,49,0
9,196090,-14970,3937,18907,0.5,48,-1
10,179810,-3195,7954,11149,0.0,48,0
11,168892,-10530,2232,12762,7.9,48,0
12,180970,10503,16437,5934,0.0,47,-1
13,175333,-5193,9945,15138,0.0,47,0
14,164873,-10577,1861,12438,0.0,47,0
15,152760,-12488,1692,14180,0.0,47,0
16,169389,-268,14970,15238,3.1,46,-1
17,150846,-3046,8801,11847,0.0,46,0
18,150846,-3046,8801,11847,2.1,46,0
19,141933,-8941,2692,11633,2.0,46,0
20,131454,-10564,971,11535,2.5,46,0
21,126877,-4867,1322,6189,1.2,45,-1
22,122372,-4589,997,5586,0.0,45,0
23,109234,-12586,473,13059,0.0,45,0
24,106069,-3933,321,4254,0.0,45,0
0,3122,0,0,0,0.0,50,0
1,2085,-1054,27,1081,0.0,50,0
2,1677,-475,61,536,0.0,49,-1
3,1456,-250,30,280,0.0,49,0
4,1304,-176,44,220,0.0,49,0
5,1241,-72,28,100,0.0,49,0
6,1205,-50,13,63,0.0,49,0
7,1214,-16,31,47,0.3,49,0
8,1309,11,65,54,0.0,49,0
9,1363,16,65,49,0.0,49,0
10,1393,4,62,58,0.0,49,0
11,1385,-20,43,63,0.0,49,0
12,1387,-12,38,50,0.0,49,0
13,1393,-24,41,65,2.7,49,0
14,1434,15,36,21,2.1,49,0
15,1487,32,86,54,1.8,49,0
16,2390,279,447,168,0.0,49,0
17,1709,-102,53,155,0.1,49,0
18,1709,-102,53,155,0.0,49,0
19,1698,-65,72,137,0.0,49,0
20,1617,-94,10,104,0.0,49,0
21,1574,-58,9,67,0.0,49,0
22,1547,-41,17,58,0.0,49,0
23,1523,-44,18,62,0.0,49,0
24,1571,27,72,45,0.0,48,-1
0,5313,0,0,0,0.0,45,0
1,6402,-468,216,684,0.0,45,0
2,6429,-525,121,646,0.0,45,0
3,6529,-279,220,499,0.0,45,0
4,6582,-303,268,571,0.0,45,0
5,6601,-204,208,412,0.0,45,0
6,6550,-154,127,281,0.0,44,-1
7,6490,-129,85,214,0.0,44,0
8,6584,-23,256,279,0.0,44,0
9,6465,-165,97,262,0.0,44,0
10,6283,-87,87,174,0.0,44,0
11,6232,-69,43,112,0.0,44,0
12,6163,-108,48,156,0.0,44,0
13,6140,-79,86,165,0.0,44,0
14,6094,-70,35,105,0.0,44,0
15,6064,-73,43,116,0.0,44,0
16,6682,-8,232,240,0.0,44,0
17,6048,-81,47,128,0.0,44,0
18,6048,-81,47,128,0.0,44,0
19,6017,-81,52,133,0.0,43,-1
20,6002,-46,30,76,0.0,43,0
21,5972,-46,25,71,0.0,43,0
22,5936,-61,34,95,0.0,43,0
23,5888,-73,48,121,0.0,43,0
24,5881,-38,44,82,0.0,43,0
0,2064,0,0,0,0.0,50,0
1,2435,-372,134,506,0.0,50,0
2,2358,-345,166,511,0.7,50,0
3,2527,-92,273,365,0.0,50,0
4,2462,-242,163,405,0.0,49,-1
5,2416,-140,98,238,6.7,49,0
6,4032,1242,1567,325,1.2,49,0
7,4446,308,930,622,1.1,49,0
8,4823,217,871,654,5.7,49,0
9,5235,295,841,546,0.0,49,0
10,4360,-180,175,355,3.8,49,0
11,4534,129,344,215,5.4,49,0
12,4549,-30,280,310,0.0,49,0
13,4322,-259,191,450,3.7,49,0
14,4235,-115,91,206,3.0,49,0
15,4271,-12,247,259,0.8,49,0
16,6518,595,1246,651,1.1,49,0
17,4647,-297,175,472,0.1,49,0
18,4647,-297,175,472,0.0,49,0
19,4406,-326,115,441,3.0,49,0
20,4107,-302,40,342,0.0,49,0
21,3961,-177,32,209,0.0,49,0
22,3798,-185,21,206,0.0,49,0
23,3654,-160,37,197,0.0,49,0
24,3606,-92,30,122,0.9,49,0
0,538610,0,0,0,10.5,65,0
1,985394,287580,372449,84869,0.8,65,0
2,708132,-252768,39691,292459,5.5,65,0
3,706711,-33427,73218,106645,16.6,64,-1
4,987870,237723,341620,103897,7.2,65,1
5,992172,4821,129025,124204,4.1,65,0
6,934766,-63076,56857,119933,15.6,65,0
7,1236495,275289,308845,33556,0.9,66,1
8,886652,-309536,23269,332805,0.0,65,-1
9,839846,-78963,35988,114951,9.2,65,0
10,1300824,277587,315694,38107,2.0,66,1
11,1263358,-23869,58463,82332,9.7,66,0
12,1353430,79431,118561,39130,8.3,66,0
13,1215598,-136215,84104,220319,0.0,66,0
14,1108095,-111064,31923,142987,5.5,66,0
15,1104459,-9486,81380,90866,1.0,65,-1
16,2230524,448646,545303,96657,3.0,66,1
17,1599004,74530,274169,199639,4.1,66,0
18,1599004,74530,274169,199639,0.6,66,0
19,1483790,-136722,105010,241732,5.6,66,0
20,1410324,-76417,54736,131153,15.8,66,0
21,1950311,521506,536264,14758,6.3,67,1
22,2027762,75641,138008,62367,2.4,68,1
23,1007441,-986874,6768,993642,0.0,67,-1
24,685838,-358166,945,359111,0.0,66,-1
0,65008,0,0,0,0.0,60,0
1,59692,-10853,6621,17474,0.9,60,0
2,42093,-18454,2181,20635,0.0,60,0
3,31500,-11518,803,12321,0.3,59,-1
4,27898,-4397,1159,5556,0.2,58,-1
5,24667,-3509,450,3959,0.6,58,0
6,23264,-1706,485,2191,1.0,58,0
7,23192,-423,1242,1665,0.0,57,-1
8,18679,-4271,256,4527,0.0,57,0
9,16496,-2403,52,2455,0.0,57,0
10,14382,-594,75,669,0.0,56,-1
11,14056,-353,61,414,9.2,56,0
12,15676,1458,1810,352,0.3,56,0
13,14790,-902,236,1138,0.0,56,0
14,14206,-610,21,631,0.0,56,0
15,13637,-590,20,610,0.0,56,0
16,13125,-458,62,520,1.3,56,0
17,12858,-321,10,331,0.0,56,0
18,12858,-321,10,331,2.0,56,0
19,12856,-79,209,288,4.1,56,0
20,12750,-138,106,244,5.7,56,0
21,12657,-134,101,235,18.1,56,0
22,12977,255,491,236,0.0,56,0
23,12657,-368,61,429,3.5,56,0
24,12612,-107,62,169,1.9,56,0
0,76806,0,0,0,5.9,45,0
1,256522,115980,150327,34347,0.3,45,0
2,195388,-49564,22304,71868,0.0,45,0
3,186537,-16133,6351,22484,0.5,45,0
4,176226,-11296,17109,28405,4.7,44,-1
5,165696,-12098,5144,17242,2.4,44,0
6,159005,-8152,4098,12250,3.2,44,0
7,154266,-5268,5809,11077,5.1,43,-1
8,152916,-1460,13681,15141,1.7,43,0
9,160124,4749,13712,8963,5.6,43,0
10,202764,34021,40533,6512,0.9,43,0
11,207878,7086,17779,10693,1.2,43,0
12,230903,20980,30254,9274,0.0,43,0
13,202733,-27219,10273,37492,0.3,43,0
14,190118,-13457,5495,18952,0.0,43,0
15,171803,-18716,4747,23463,0.0,43,0
16,121346,-24444,4466,28910,0.0,43,0
17,118026,-27104,441,27545,1.0,43,0
18,118026,-27104,441,27545,0.3,43,0
19,114842,-8590,3994,12584,3.0,42,-1
20,109083,-5840,2113,7953,4.6,42,0
21,124581,14329,17284,2955,4.6,42,0
22,115456,-8794,4254,13048,1.5,42,0
23,110800,-4585,4673,9258,3.0,42,0
24,109986,-1496,4028,5524,0.4,42,0
0,0,0,0,0,0.0,45,0
1,489,115,243,128,0.0,45,0
2,606,72,188,116,0.0,45,0
3,725,76,234,158,0.0,45,0
4,963,129,372,243,0.0,45,0
5,965,-28,104,132,0.0,45,0
6,1039,25,150,125,0.0,45,0
7,1848,127,416,289,0.0,45,0
8,1321,10,169,159,0.2,45,0
9,1321,10,169,159,0.0,45,0
10,1359,-11,209,220,0.0,45,0
11,1274,-115,72,187,0.0,45,0
12,1271,-33,69,102,0.0,45,0
13,1242,-53,69,122,0.0,45,0
14,1300,3,156,153,0.0,45,0
15,1548,208,358,150,0.0,45,0
0,0,0,0,0,0.0,40,0
1,841,664,725,61,0.0,40,0
2,1451,541,960,419,0.0,40,0
3,2960,1114,1514,400,0.0,40,0
4,3087,125,631,506,0.0,40,0
5,3663,465,920,455,0.0,40,0
6,27086,1240,2131,891,0.0,40,0
7,6285,370,1050,680,0.0,40,0
8,6285,370,1050,680,0.0,40,0
9,5638,51,500,449,0.0,40,0
10,5627,-59,232,291,0.0,40,0
11,5637,-33,216,249,0.0,40,0
12,5546,-148,234,382,0.0,40,0
13,5367,-234,242,476,0.0,40,0
14,5515,78,419,341,0.0,40,0
0,339175,0,0,0,0.0,45,0
1,401081,22080,85310,63230,0.0,45,0
2,343265,-41736,28734,52167,0.0,45,0
3,368689,22817,30270,7453,0.0,45,0
4,482250,98573,175100,76527,0.2,45,0
5,523816,35867,86546,50679,1.3,45,0
6,500510,-22665,35284,57949,2.5,45,0
7,491847,-10838,34712,45550,0.5,45,0
8,456502,-32957,40466,73423,1.2,45,0
9,465717,-1015,32272,33287,5.1,45,0
10,481379,10048,44667,34619,0.0,45,0
11,484957,5414,44481,39067,0.1,45,0
12,487402,136,29408,29272,2.4,45,0
13,482162,-5582,23976,29558,0.0,45,0
14,513055,25789,58074,32285,2.0,45,0
15,515619,2118,33867,31749,5.7,45,0
16,525179,7822,45034,37212,0.1,45,0
17,764093,45185,102055,56870,1.8,45,0
18,644114,57648,115917,58269,0.6,45,0
19,610535,-22136,58453,80589,0.4,45,0
20,594745,-17112,34047,51159,1.2,45,0
21,585428,-11008,33573,44581,0.0,45,0
22,539627,-46012,13466,59478,3.7,45,0
23,517132,-24034,30976,55010,0.0,44,-1
24,509857,-9846,30464,40310,0.0,44,0
25,509695,-4542,54981,59523,0.0,44,0
0,17568,0,0,0,2.7,60,0
1,21686,30,4385,4355,0.0,60,0
2,17103,-5336,1203,6539,2.1,59,-1
3,13929,-3619,377,3996,0.4,58,-1
4,12462,-1828,465,2293,5.1,58,0
5,12394,-400,761,1161,0.0,58,0
6,11599,-911,372,1283,0.0,57,-1
7,10984,-701,235,936,0.0,57,0
8,10603,-527,339,866,0.0,57,0
9,10268,-394,112,506,0.0,56,-1
10,9887,-409,128,537,0.0,56,0
11,9638,-287,98,385,0.2,56,0
12,9550,-126,95,221,0.0,56,0
13,9455,-109,127,236,0.0,56,0
14,9268,-222,106,328,0.0,56,0
15,9171,-113,61,174,0.0,56,0
16,9101,-89,78,167,0.0,56,0
17,9179,-61,309,370,6.1,55,-1
18,10199,947,1413,466,0.0,55,0
19,10012,-116,499,615,2.0,55,0
20,10141,74,469,395,1.5,55,0
21,10804,586,1035,449,6.4,55,0
22,14685,3408,4435,1027,2.6,55,0
23,16464,1511,3539,2028,3.0,55,0
24,16593,130,1756,1626,1.8,55,0
25,16336,-403,1554,1957,0.0,55,0
0,64923,0,0,0,1.2,55,0
1,63573,-6507,6536,13043,0.0,55,0
2,52823,-12442,4271,16713,1.9,54,-1
3,45992,-8265,3458,11723,6.6,54,0
4,45304,-2816,8399,11215,0.9,54,0
5,49918,3035,10598,7563,2.5,53,-1
6,49783,-912,6702,7614,0.2,53,0
7,46565,-3311,3296,6607,4.9,53,0
8,52670,4191,9968,5777,1.8,53,0
9,54099,1187,5878,4691,0.0,53,0
10,49892,-4057,3077,7134,0.0,53,0
11,46004,-4007,1745,5752,1.9,53,0
12,45027,-1296,1969,3265,21.0,52,-1
13,62808,16226,18807,2581,4.6,52,0
14,84093,19479,27225,7746,2.4,52,0
15,93316,9120,16460,7340,5.6,52,0
16,102195,8206,20581,12375,4.3,52,0
17,266193,55063,82054,26991,5.4,52,0
18,153556,-1774,34486,36260,11.3,52,0
19,162520,4059,32837,28778,1.0,52,0
20,164921,1900,20370,18470,0.5,52,0
21,179939,13597,30707,17110,4.4,52,0
22,159061,-20800,9615,30415,2.8,52,0
23,145907,-13181,13489,26670,11.3,52,0
24,144533,-3261,12395,15656,0.1,52,0
25,134147,-10340,12324,22664,3.4,52,0
0,135308,0,0,0,1.5,50,0
1,126555,-14295,3894,18189,2.1,50,0
2,113907,-14673,4266,18939,2.7,50,0
3,99516,-15282,1429,16711,1.8,49,-1
4,95073,-7235,5612,12847,6.2,49,0
5,85940,-8170,1585,9755,4.7,49,0
6,80889,-5762,996,6758,2.1,49,0
7,76470,-4609,936,5545,1.4,48,-1
8,72136,-4706,1739,6445,3.8,48,0
9,71690,-1278,2712,3990,3.4,48,0
10,66169,-4963,542,5505,4.1,48,0
11,63043,-3551,555,4106,1.8,47,-1
12,60045,-3126,212,3338,1.6,47,0
13,58608,-1636,960,2596,3.1,47,0
14,55771,-2892,593,3485,1.5,47,0
15,55326,-625,1226,1851,1.7,47,0
16,54145,-1275,953,2228,4.9,46,-1
17,72034,2527,6315,3788,0.8,46,0
18,52011,-4014,211,4225,3.8,46,0
19,50856,-2191,369,2560,2.6,46,0
20,49845,-1115,432,1547,0.8,46,0
21,51129,1044,2205,1161,9.0,46,0
22,49797,-1382,584,1966,1.9,46,0
23,48501,-1315,522,1837,4.0,46,0
24,48412,-368,922,1290,0.4,46,0
25,44249,-4006,99,4105,0.0,46,0
0,33140,0,0,0,6.0,60,0
1,32626,-3434,2704,6138,0.5,60,0
2,27408,-6034,1709,7743,0.0,59,-1
3,21706,-6120,458,6578,1.5,58,-1
4,17150,-4871,396,5267,0.0,58,0
5,12826,-4432,54,4486,0.0,57,-1
6,10781,-2206,30,2236,0.0,57,0
7,9622,-1186,25,1211,0.0,57,0
8,8987,-678,115,793,4.9,56,-1
9,9216,113,359,246,5.0,56,0
10,9074,-214,237,451,2.3,56,0
11,8987,-177,150,327,3.0,56,0
12,8946,-84,116,200,4.0,56,0
13,9297,266,471,205,0.0,56,0
14,9291,-114,349,463,0.0,56,0
15,9285,-47,241,288,1.0,56,0
16,9123,-207,201,408,3.3,56,0
17,11368,802,1539,737,5.5,56,0
18,9404,-649,128,777,9.0,56,0
19,9313,-229,211,440,6.5,56,0
20,9570,198,514,316,2.2,56,0
21,10654,949,1540,591,7.8,56,0
22,9991,-675,404,1079,2.9,56,0
23,9588,-491,238,729,0.0,56,0
24,9304,-318,246,564,0.9,56,0
25,9299,-65,311,376,1.8,56,0
0,340758,0,0,0,2.6,55,0
1,306284,-42400,5284,47684,1.4,55,0
2,264639,-44946,4071,49017,4.1,55,0
3,224544,-41947,1296,43243,3.1,54,-1
4,202683,-25491,5038,30529,3.7,54,0
5,177038,-24779,504,25283,4.7,54,0
6,159365,-18807,522,19329,2.0,53,-1
7,147117,-12529,424,12953,1.2,53,0
8,125382,-20719,336,21055,0.0,53,0
9,113968,-12740,80,12820,0.0,52,-1
10,101607,-12228,32,12260,0.0,52,0
11,97055,-5437,146,5583,2.8,51,-1
12,93518,-3631,126,3757,1.8,51,0
13,91013,-2640,318,2958,1.9,51,0
14,87805,-3236,279,3515,3.6,51,0
15,86510,-1464,409,1873,3.1,51,0
16,84823,-1770,289,2059,1.7,51,0
17,81197,-2777,825,3602,0.0,50,-1
18,78986,-2840,5,2845,4.8,50,0
19,78043,-1476,176,1652,0.0,50,0
20,75960,-2069,49,2118,0.0,50,0
21,74158,-1841,33,1874,0.0,50,0
22,72540,-1619,11,1630,0.0,50,0
23,70888,-1610,16,1626,3.8,50,0
24,70723,-314,285,599,2.7,50,0
25,70233,-546,191,737,2.6,50,0
0,38334,0,0,0,3.2,50,0
1,36349,-3653,2642,6295,0.0,50,0
2,28512,-8130,874,9004,0.1,49,-1
3,24011,-4940,510,5450,0.0,49,0
4,19361,-4876,479,5355,4.3,48,-1
5,17441,-2164,460,2624,0.0,48,0
6,15832,-1683,184,1867,0.7,48,0
7,14959,-990,421,1411,1.8,47,-1
8,14370,-789,777,1566,1.5,47,0
9,14572,-3,940,943,2.5,47,0
10,13541,-984,477,1461,0.4,47,0
11,13045,-555,274,829,0.0,47,0
12,12682,-399,191,590,0.0,46,-1
13,12349,-379,232,611,0.0,46,0
14,12066,-336,324,660,6.5,46,0
15,11900,-210,222,432,2.0,46,0
16,11653,-284,210,494,3.1,46,0
17,12933,-19,759,778,1.8,46,0
18,11373,-294,221,515,6.1,46,0
19,11129,-337,225,562,1.9,46,0
20,10882,-279,168,447,3.3,45,-1
21,10731,-190,152,342,0.6,45,0
22,10520,-242,101,343,2.5,45,0
23,10323,-214,148,362,3.3,45,0
24,10384,3,245,242,2.1,45,0
25,10213,-186,142,328,5.5,45,0
0,9649,0,0,0,0.0,45,0
1,10250,-919,252,1171,0.0,45,0
2,9815,-988,174,1162,0.0,45,0
3,9496,-658,104,762,0.0,45,0
4,9205,-594,230,824,0.0,44,-1
5,9039,-291,215,506,0.0,44,0
6,8965,-182,161,343,0.0,44,0
7,8818,-200,87,287,0.0,44,0
8,8692,-241,97,338,0.0,44,0
9,8596,-143,63,206,0.0,44,0
10,8443,-201,46,247,0.0,44,0
11,8344,-160,55,215,0.0,44,0
12,8225,-140,29,169,0.0,44,0
13,8151,-109,28,137,0.0,44,0
14,8123,-94,102,196,0.0,43,-1
15,8084,-71,60,131,0.0,43,0
16,8021,-97,61,158,0.0,43,0
17,8623,-86,197,283,0.0,43,0
18,7925,-85,88,173,0.0,43,0
19,7865,-114,82,196,0.0,43,0
20,7847,-40,59,99,0.0,43,0
21,7892,19,119,100,0.0,43,0
22,7895,-19,137,156,0.0,43,0
23,7862,-96,127,223,0.0,43,0
24,8042,125,304,179,0.0,43,0
25,7847,-230,185,415,0.0,43,0
0,304826,0,0,0,4.3,55,0
1,280431,-35015,5974,40989,2.4,55,0
2,244605,-38987,5084,44071,4.4,55,0
3,203736,-42243,1472,43715,3.7,54,-1
4,206350,-7176,18958,26134,2.5,54,0
5,173191,-27082,1266,28348,5.7,54,0
6,157961,-16725,1063,17788,2.6,53,-1
7,144676,-13441,798,14239,6.3,53,0
8,131914,-13099,1850,14949,5.7,52,-1
9,128193,-4993,3335,8328,7.0,52,0
10,117337,-10158,754,10912,1.2,52,0
11,110112,-7916,578,8494,1.5,51,-1
12,103769,-6551,303,6854,3.1,51,0
13,99444,-4601,1015,5616,0.8,51,0
14,93769,-5658,738,6396,1.4,50,-1
15,91653,-2408,1107,3515,2.8,50,0
16,88607,-3183,780,3963,0.0,50,0
17,80735,-5903,1292,7195,0.0,50,0
18,76823,-5479,15,5494,0.0,50,0
19,74905,-2870,161,3031,1.9,49,-1
20,73846,-1172,294,1466,0.7,49,0
21,74855,836,2143,1307,0.0,49,0
22,71614,-3203,124,3327,0.0,49,0
23,67812,-3667,15,3682,0.0,49,0
24,67068,-1007,203,1210,1.6,49,0
25,66412,-712,334,1046,0.6,49,0
0,11802,0,0,0,0.0,45,0
1,11824,-1620,374,1994,0.0,45,0
2,10695,-1621,246,1867,2.4,44,-1
3,11028,-136,901,1037,1.6,44,0
4,13426,1658,3477,1819,1.6,44,0
5,13870,381,1909,1528,0.0,44,0
6,13238,-730,627,1357,0.0,44,0
7,12250,-1032,252,1284,0.0,44,0
8,11567,-791,193,984,0.3,44,0
9,11346,-362,209,571,0.0,44,0
10,10764,-613,161,774,0.0,43,-1
11,10510,-344,205,549,0.0,43,0
12,10189,-380,45,425,1.0,43,0
13,9981,-240,116,356,1.1,43,0
14,10096,6,430,424,4.4,43,0
15,10206,71,364,293,1.0,43,0
16,10039,-204,177,381,0.0,43,0
17,8976,-799,100,899,0.0,43,0
18,8690,-517,5,522,0.0,43,0
19,8297,-476,18,494,0.0,42,-1
20,8051,-257,17,274,0.0,42,0
21,7865,-193,30,223,0.0,42,0
22,7652,-216,46,262,0.0,42,0
23,7386,-272,90,362,0.0,42,0
24,7200,-207,54,261,0.0,42,0
25,7058,-151,129,280,0.0,42,0
0,1006715,0,0,0,1.6,50,0
1,885692,-142331,18701,161032,0.0,50,0
2,493796,-389862,4111,393973,0.0,49,-1
3,411407,-94514,1222,95736,1.4,49,0
4,334285,-78423,2038,80461,2.0,49,0
5,298178,-38978,817,39795,2.2,49,0
6,277843,-22002,773,22775,1.7,49,0
7,259518,-18488,706,19194,1.8,49,0
8,227799,-30097,540,30637,3.7,48,-1
9,221596,-9102,1472,10574,2.2,48,0
10,208448,-12486,282,12768,1.9,48,0
11,200129,-9247,284,9531,2.4,48,0
12,192626,-7627,149,7776,2.1,47,-1
13,186552,-6371,438,6809,3.5,47,0
14,179131,-7383,385,7768,3.1,47,0
15,175150,-4308,602,4910,0.9,47,0
16,171463,-3809,459,4268,2.3,47,0
17,172236,-2824,3011,5835,1.7,47,0
18,163766,-4075,556,4631,2.6,47,0
19,155068,-9810,156,9966,0.0,47,0
20,152567,-2785,174,2959,2.6,47,0
21,152556,-189,1380,1569,5.0,47,0
22,151497,-1208,771,1979,1.1,47,0
23,149524,-1895,519,2414,1.4,47,0
24,145915,-3791,210,4001,0.0,47,0
25,139901,-5815,70,5885,0.0,47,0
0,46550,0,0,0,2.2,50,0
1,45105,-4336,1311,5647,2.1,50,0
2,42128,-4195,1664,5859,0.0,50,0
3,25380,-16582,105,16687,0.0,49,-1
4,19237,-6581,30,6611,0.0,49,0
5,16581,-2831,23,2854,0.0,49,0
6,14950,-1783,149,1932,0.0,48,-1
7,13522,-1451,12,1463,0.0,48,0
8,12462,-1077,71,1148,0.0,48,0
9,12016,-486,38,524,0.0,48,0
10,11585,-428,104,532,0.0,48,0
11,11242,-373,64,437,0.0,48,0
12,10973,-271,6,277,0.0,48,0
13,10739,-234,4,238,0.0,48,0
14,10425,-319,18,337,0.0,47,-1
15,10285,-146,9,155,0.0,47,0
16,10224,-66,97,163,0.0,47,0
17,9971,-224,43,267,0.0,47,0
18,10021,21,143,122,0.0,47,0
19,9845,-192,53,245,0.0,47,0
20,9745,-101,52,153,0.0,47,0
21,9719,-33,82,115,0.0,47,0
22,9723,7,135,128,0.0,47,0
23,9650,-89,100,189,0.0,47,0
24,9522,-132,27,159,0.0,47,0
25,9475,-48,72,120,0.0,47,0
0,781245,0,0,0,4.4,55,0
1,702490,-90423,14557,104980,4.8,55,0
2,547478,-156719,9129,165848,10.1,54,-1
3,455856,-96969,4481,101450,3.1,54,0
4,367194,-90653,3611,94264,2.9,53,-1
5,308151,-60979,830,61809,2.7,53,0
6,271093,-39498,959,40457,1.8,52,-1
7,239313,-31999,836,32835,3.8,52,0
8,214754,-24213,1651,25864,2.1,51,-1
9,202633,-13637,1170,14807,2.9,51,0
10,184107,-18180,590,18770,4.1,50,-1
11,179054,-6231,1364,7595,0.0,50,0
12,170581,-8450,414,8864,0.0,50,0
13,162383,-8400,445,8845,2.8,50,0
14,138708,-23236,109,23345,0.0,50,0
15,131330,-7911,11,7922,0.0,50,0
16,124691,-6716,47,6763,0.0,49,-1
17,121807,-3111,1023,4134,7.7,49,0
18,119560,-1901,328,2229,1.5,49,0
19,117840,-2180,225,2405,5.4,49,0
20,116390,-1503,459,1962,1.6,49,0
21,116027,-466,1150,1616,6.0,49,0
22,114273,-1741,292,2033,1.4,49,0
23,112378,-1827,247,2074,1.3,49,0
24,111762,-805,598,1403,1.0,49,0
25,110677,-1129,454,1583,1.1,49,0
0,2316,0,0,0,0.0,50,0
1,2388,-379,95,474,0.5,50,0
2,2274,-312,82,394,7.8,49,-1
3,2349,-57,150,207,2.3,49,0
4,2365,-109,140,249,0.0,49,0
5,2270,-149,53,202,3.9,49,0
6,2292,-39,115,154,0.4,49,0
7,2246,-96,40,136,1.8,49,0
8,2216,-87,42,129,0.0,48,-1
9,2187,-54,33,87,0.0,48,0
10,2108,-103,18,121,1.4,48,0
11,2095,-43,33,76,0.0,48,0
12,2082,-25,41,66,0.0,48,0
13,2073,-29,26,55,1.3,48,0
14,2075,-36,39,75,5.2,48,0
15,2105,20,64,44,2.1,48,0
16,2137,7,71,64,2.8,48,0
17,3012,155,361,206,6.3,48,0
18,2254,-91,66,157,0.0,48,0
19,2142,-134,39,173,0.0,48,0
20,2051,-95,36,131,0.0,48,0
21,1983,-70,19,89,0.0,47,-1
22,1929,-57,7,64,0.0,47,0
23,1931,-17,21,38,6.6,47,0
24,1975,21,69,48,0.0,47,0
25,1936,-50,14,64,0.4,47,0
0,45716,0,0,0,6.8,60,0
1,44872,-4753,4011,8764,1.9,60,0
2,34821,-10941,1558,12499,0.7,59,-1
3,26929,-8582,527,9109,1.1,58,-1
4,23384,-4152,1004,5156,8.0,58,0
5,21420,-2145,606,2751,5.5,57,-1
6,21028,-727,1164,1891,1.0,57,0
7,20560,-649,1027,1676,0.1,57,0
8,19701,-1049,909,1958,7.0,57,0
9,19536,-360,792,1152,17.7,57,0
10,19189,-451,923,1374,9.0,56,-1
11,21222,1703,2914,1211,0.0,56,0
12,19492,-1606,361,1967,0.0,56,0
13,18008,-1519,65,1584,0.0,56,0
14,16645,-1379,76,1455,1.2,56,0
15,16410,-294,161,455,0.0,56,0
16,15920,-518,98,616,0.0,56,0
17,15153,-716,114,830,0.0,56,0
18,14994,-237,74,311,0.0,56,0
19,14621,-393,45,438,0.0,56,0
20,14486,-164,85,249,0.3,56,0
21,15281,721,1002,281,5.2,56,0
22,14855,-435,214,649,4.8,56,0
23,15038,118,566,448,2.5,56,0
24,15015,-57,384,441,1.0,56,0
25,15112,49,504,455,2.3,56,0
0,28676,0,0,0,0.0,60,0
1,18158,-11948,1069,13017,0.0,60,0
2,10410,-8115,130,8245,0.0,59,-1
3,7857,-2894,42,2936,0.0,59,0
4,6546,-1399,88,1487,0.0,58,-1
5,6011,-590,38,628,0.0,58,0
6,5845,-206,239,445,0.0,58,0
7,5384,-464,29,493,0.0,58,0
8,5138,-259,41,300,0.0,58,0
9,5067,-90,42,132,3.8,58,0
10,5310,169,329,160,0.0,58,0
11,5111,-205,58,263,0.2,58,0
12,5114,-20,84,104,2.9,58,0
13,5237,94,218,124,0.0,58,0
14,5170,-86,159,245,0.2,58,0
15,5198,8,121,113,1.8,58,0
16,5302,74,198,124,0.0,58,0
17,6239,406,1004,598,0.0,58,0
18,5619,-130,212,342,0.0,58,0
19,5529,-127,232,359,0.0,58,0
20,5473,-79,108,187,0.0,58,0
21,5582,83,290,207,0.0,58,0
22,5484,-111,149,260,0.0,58,0
23,5430,-91,146,237,0.0,58,0
24,5482,26,201,175,0.0,58,0
25,5380,-130,87,217,0.0,58,0
0,10068,0,0,0,2.7,50,0
1,10578,-495,1080,1575,3.5,50,0
2,11089,-161,1686,1847,3.8,50,0
3,11153,-331,1237,1568,1.7,50,0
4,10886,-691,1028,1719,3.6,50,0
5,10337,-632,603,1235,10.5,50,0
6,12880,1953,3029,1076,4.9,50,0
7,13881,843,2268,1425,3.9,50,0
8,17910,3320,5783,2463,3.7,50,0
9,19089,1116,2979,1863,5.3,50,0
10,17499,-1507,1257,2764,2.3,50,0
11,16430,-1182,716,1898,1.1,50,0
12,15662,-860,444,1304,0.0,50,0
13,13789,-1919,221,2140,0.0,50,0
14,10730,-3045,64,3109,0.0,50,0
15,9883,-911,28,939,0.0,50,0
16,9160,-744,92,836,0.0,49,-1
17,8178,-796,71,867,0.0,49,0
18,8042,-357,15,372,0.0,49,0
19,7908,-167,258,425,0.0,49,0
20,7531,-391,45,436,0.0,49,0
21,7380,-150,78,228,0.0,49,0
22,7148,-232,19,251,0.0,49,0
23,7290,115,334,219,0.0,49,0
24,7325,23,269,246,0.0,49,0
25,6965,-361,67,428,0.0,49,0
0,65020,0,0,0,0.0,45,0
1,63505,-5317,4520,9837,0.4,45,0
2,84704,18084,39036,20952,7.4,45,0
3,95600,9170,21711,12541,0.6,45,0
4,79376,-15157,5581,20738,0.0,45,0
5,72615,-7718,1651,9369,2.4,45,0
6,69125,-3959,1427,5386,0.0,45,0
7,65444,-4043,2379,6422,0.0,44,-1
8,60358,-5230,2708,7938,0.0,44,0
9,58325,-2513,1632,4145,5.9,44,0
10,77712,8454,14749,6295,0.7,43,-1
11,118706,41515,49316,7801,0.0,43,0
12,140270,23683,33416,9733,7.1,43,0
13,163649,23044,32200,9156,2.8,43,0
14,192210,26141,41105,14964,2.7,44,1
15,175739,-13648,2237,15885,1.0,44,0
16,159527,-16630,1991,18621,0.0,44,0
17,200892,-6469,22924,29393,9.9,43,-1
18,165495,1806,28128,26322,5.7,43,0
19,150488,-8571,16286,24857,6.7,43,0
20,134303,-16695,9066,25761,0.6,42,-1
21,134611,-1023,13678,14701,0.0,42,0
22,129893,-5342,9533,14875,0.6,42,0
23,133391,1959,18218,16259,0.0,42,0
24,129864,-3903,9761,13664,0.0,42,0
25,133376,122,14460,14338,3.1,42,0
0,462939,0,0,0,1.8,50,0
1,440147,-41600,15075,56675,1.1,50,0
2,377916,-66442,9045,75487,5.2,50,0
3,335363,-45840,3387,49227,2.1,50,0
4,320507,-26830,21356,48186,2.8,50,0
5,266742,-47258,2333,49591,2.2,49,-1
6,244340,-24585,1547,26132,4.4,49,0
7,232343,-12557,1946,14503,3.1,49,0
8,216545,-16255,2690,18945,1.8,48,-1
9,211796,-6816,3890,10706,3.5,48,0
10,197031,-13532,1229,14761,1.9,48,0
11,188768,-9663,1160,10823,2.5,48,0
12,179375,-9641,403,10044,2.7,47,-1
13,173530,-6437,1604,8041,2.0,47,0
14,165780,-7748,1216,8964,1.1,47,0
15,161426,-4880,2134,7014,1.7,47,0
16,156955,-4674,2030,6704,1.6,47,0
17,199026,2975,13461,10486,1.9,47,0
18,149730,-8191,1915,10106,1.0,47,0
19,148083,-4745,1910,6655,2.0,46,-1
20,146445,-1873,1817,3690,3.0,46,0
21,150690,3544,6386,2842,2.6,46,0
22,147723,-3147,2300,5447,0.0,46,0
23,143844,-3746,1644,5390,3.8,46,0
24,143299,-1292,1813,3105,2.2,46,0
25,140325,-2974,1551,4525,5.6,46,0
0,51564,0,0,0,0.0,45,0
1,53357,-5634,3691,9325,1.5,45,0
2,51373,-4191,4301,8492,2.5,45,0
3,50089,-2374,2578,4952,0.0,45,0
4,47413,-3642,2602,6244,0.0,45,0
5,43424,-4113,651,4764,3.4,45,0
6,42247,-1699,902,2601,2.2,45,0
7,37663,-4405,406,4811,0.0,44,-1
8,36314,-1746,694,2440,2.1,44,0
9,34520,-1831,198,2029,0.0,44,0
10,31926,-2515,45,2560,0.0,44,0
11,31258,-950,304,1254,1.0,43,-1
12,30989,-358,364,722,5.4,43,0
13,31369,279,972,693,1.8,43,0
14,33052,1464,2702,1238,2.4,43,0
15,34919,1768,2822,1054,3.3,43,0
16,34916,-8,1456,1464,2.7,43,0
17,55821,2359,5250,2891,6.0,43,0
18,38653,1423,5317,3894,4.2,43,0
19,38443,-760,2350,3110,3.0,43,0
20,38303,-299,1451,1750,1.2,43,0
21,42542,3848,5392,1544,5.2,43,0
22,38599,-3836,868,4704,0.0,43,0
23,36648,-1960,812,2772,3.8,43,0
24,36840,-108,1184,1292,1.7,43,0
25,36686,-344,1647,1991,5.4,43,0
0,7325,0,0,0,0.0,45,0
1,7666,-1027,362,1389,0.0,45,0
2,6912,-1176,225,1401,0.0,45,0
3,6352,-869,102,971,0.0,45,0
4,5911,-598,132,730,0.0,44,-1
5,5648,-355,77,432,0.0,44,0
6,5446,-280,77,357,0.0,44,0
7,5194,-294,34,328,0.0,44,0
8,5071,-209,105,314,0.0,43,-1
9,5000,-103,86,189,0.0,43,0
10,4935,-107,76,183,0.0,43,0
11,4876,-102,54,156,0.0,43,0
12,4808,-83,30,113,0.0,43,0
13,4742,-85,31,116,5.7,43,0
14,6929,1825,2197,372,0.0,43,0
15,6524,-252,211,463,0.0,43,0
16,6171,-387,133,520,5.5,43,0
17,10936,462,1146,684,10.5,43,0
18,6814,90,648,558,3.5,43,0
19,6759,-143,352,495,0.1,43,0
20,6607,-177,146,323,1.8,43,0
21,7139,473,736,263,9.5,43,0
22,9370,1999,2607,608,2.1,43,0
23,9736,334,1176,842,2.2,43,0
24,9967,186,882,696,4.0,43,0
25,8966,-1011,454,1465,0.0,43,0
0,4284,0,0,0,0.0,45,0
1,5084,-446,211,657,0.0,45,0
2,5067,-524,202,726,0.0,45,0
3,4869,-461,70,531,0.0,45,0
4,4781,-343,91,434,0.1,45,0
5,4376,-424,33,457,0.0,44,-1
6,4182,-241,58,299,1.5,44,0
7,4268,-9,129,138,2.3,44,0
8,4439,63,315,252,2.9,44,0
9,4902,329,549,220,3.4,44,0
10,4639,-223,161,384,1.2,44,0
11,4529,-134,114,248,0.0,44,0
12,4396,-167,44,211,0.0,44,0
13,4352,-85,58,143,0.0,44,0
14,4281,-134,72,206,0.0,44,0
15,4238,-73,39,112,0.0,43,-1
16,4175,-84,36,120,0.0,43,0
17,4349,-28,139,167,0.0,43,0
18,4128,-83,29,112,0.0,43,0
19,4098,-71,32,103,0.0,43,0
20,4066,-53,25,78,0.0,43,0
21,4038,-53,19,72,4.7,43,0
22,4031,-27,33,60,2.3,43,0
23,4052,-17,60,77,0.0,43,0
24,4053,-30,38,68,0.0,43,0
25,4014,-59,35,94,0.0,43,0
0,0,0,0,0,0.0,40,0
1,15396,6502,7738,1236,0.0,40,0
2,33014,10444,14926,4482,0.0,40,0
3,38415,3399,7164,3765,0.0,40,0
4,40965,1179,5032,3853,0.0,40,0
5,44265,2040,4893,2853,0.0,40,0
6,45394,411,3190,2779,0.0,40,0
7,44165,-1586,1469,3055,0.0,40,0
8,43650,-1113,1491,2604,0.0,40,0
9,43312,-770,1007,1777,0.0,40,0
10,42303,-1243,857,2100,0.0,40,0
11,41876,-827,841,1668,1.3,40,0
12,43603,1239,2450,1211,0.4,40,0
13,44030,361,1823,1462,0.0,40,0
14,44256,-212,1970,2182,0.0,40,0
15,43558,-773,728,1501,0.0,40,0
16,42031,-1680,701,2381,0.0,40,0
17,40325,-2293,1156,3449,0.2,40,0
18,41313,126,1789,1663,0.0,39,-1
19,40345,-367,1535,1902,1.6,39,0
20,41514,842,2114,1272,0.0,39,0
21,42359,665,1903,1238,0.0,39,0
22,42688,127,1697,1570,0.0,39,0
23,43257,196,1852,1656,0.5,39,0
24,43727,257,1459,1202,0.9,39,0
25,45285,801,2510,1709,1.0,39,0
0,0,0,0,0,2.8,40,0
1,11938,8332,9412,1080,1.7,40,0
2,20993,10101,12150,2049,0.0,40,0
3,17312,-2621,1632,4253,0.0,40,0
4,14221,-3168,347,3515,0.0,39,-1
5,13820,-710,2067,2777,0.0,39,0
6,12884,-908,598,1506,0.0,39,0
7,12208,-740,1029,1769,0.0,39,0
8,54166,3872,6622,2750,0.0,39,0
9,15970,-1042,1200,2242,0.6,39,0
10,15882,-192,1709,1901,6.9,39,0
11,20057,3673,4944,1271,0.0,39,0
12,21541,1325,3013,1688,0.0,39,0
13,22327,481,2594,2113,1.1,39,0
14,24329,1490,3627,2137,0.0,39,0
15,25191,682,2473,1791,3.3,39,0
16,28854,2519,5230,2711,2.8,39,0
0,0,0,0,0,1.8,45,0
1,9121,2186,3081,895,0.0,45,0
2,2854,67,934,867,0.0,45,0
3,2629,-145,572,717,0.0,45,0
4,2788,56,461,405,0.0,45,0
5,2866,-26,439,465,0.0,45,0
6,4032,940,1561,621,0.0,44,-1
7,8293,3484,5273,1789,0.0,44,0
8,9051,899,2356,1457,0.0,44,0
9,11705,1819,4136,2317,0.0,44,0
0,0,0,0,0,0.0,40,0
1,181,98,119,21,0.0,40,0
2,347,44,101,57,0.0,40,0
3,631,103,195,92,0.0,40,0
4,857,94,195,101,0.0,40,0
5,1018,1,172,171,0.0,40,0
0,0,0,0,0,0.0,45,0
1,35,16,19,3,0.0,45,0
2,107,39,58,19,0.0,45,0
3,185,62,101,39,0.0,45,0
4,144,-54,33,87,0.0,45,0
0,0,0,0,0,0.0,45,0
1,42,16,18,2,0.0,45,0
2,162,83,122,39,0.0,45,0
3,323,147,199,52,0.0,45,0
4,227,-114,42,156,0.0,45,0
0,0,0,0,0,0.0,45,0
1,216,197,219,22,0.0,45,0
2,172,-82,82,164,0.0,45,0
0,14946,0,0,0,0.0,60,0
1,16099,-2687,1186,3873,0.0,60,0
2,13382,-3739,551,4290,0.0,59,-1
3,12620,-1656,475,832,0.1,59,0
4,12620,-1656,475,832,0.0,59,0
5,13952,921,2110,1189,8.9,58,-1
6,12373,-1499,541,2040,0.0,58,0
7,14232,1377,2285,908,2.5,58,0
8,17696,2775,3854,1079,6.4,58,0
9,26964,7864,10653,2789,9.8,58,0
10,51018,22771,25736,2965,4.0,58,0
11,65407,13535,20558,7023,0.4,58,0
12,63895,-925,8660,9585,1.3,58,0
13,59139,-4816,4778,9594,8.1,58,0
14,68870,8594,14346,5752,7.2,58,0
15,97926,25677,33930,8253,0.9,58,0
16,99751,2173,12833,10660,6.8,58,0
17,86950,-12941,5860,18801,0.5,58,0
18,65024,-9547,3828,13375,3.9,58,0
19,59783,-6944,3348,10292,2.0,58,0
20,51820,-8089,761,8850,0.5,58,0
21,41772,-10119,99,10218,0.0,58,0
22,34229,-7619,52,7671,0.0,58,0
23,29130,-5105,46,5151,0.0,58,0
24,27267,-2022,58,2080,0.0,58,0
25,27267,-2022,58,2080,0.0,58,0
0,30923,0,0,0,0.0,65,0
1,21317,-11983,727,12710,0.2,64,-1
2,14945,-7447,455,7902,0.0,63,-1
3,13344,-2388,622,3010,3.6,62,-1
4,12222,-1720,657,2377,0.0,62,0
5,11323,-1154,260,1414,0.0,61,-1
6,10910,-633,232,865,0.0,61,0
7,10264,-752,180,932,0.0,61,0
8,10145,-334,362,696,1.9,60,-1
9,10124,-166,289,455,1.6,60,0
10,10224,-85,320,405,0.0,60,0
11,10200,-172,273,445,1.4,60,0
12,10334,25,321,296,0.0,60,0
13,10503,70,408,338,8.0,60,0
14,16080,4944,5928,984,0.0,60,0
15,15098,-893,830,1723,0.0,60,0
16,13747,-1467,403,1870,0.0,60,0
17,12628,-240,300,540,0.0,60,0
18,12628,-240,300,540,2.4,60,0
19,12127,-629,163,792,0.0,60,0
20,12173,-334,490,244,0.0,60,0
21,13718,1484,1605,121,0.0,60,0
22,17741,3796,4661,865,6.6,60,0
23,30864,12649,15928,3279,0.6,60,0
24,44502,12879,16957,4078,5.4,60,0
25,44502,12879,16957,4078,0.1,60,0
0,87171,0,0,0,3.7,50,0
1,88465,-8986,2873,11859,1.2,50,0
2,80480,-10378,3818,14196,5.3,50,0
3,94806,8694,14565,5871,4.9,50,0
4,95509,-28,8793,8821,1.1,50,0
5,94027,-2293,4720,7013,5.2,50,0
6,104007,7876,11280,3404,1.7,50,0
7,86255,-16293,1628,17921,0.0,50,0
8,72167,-14034,321,14355,2.6,50,0
9,72387,-1341,1826,3167,1.6,50,0
10,76545,2958,5526,2568,1.9,50,0
11,76907,297,3344,3047,1.8,50,0
12,78050,983,3422,2439,1.8,50,0
13,77191,-1047,2457,3504,1.3,50,0
14,83858,5417,8883,3466,2.1,50,0
15,89351,5188,7788,2600,0.5,50,0
16,88136,-1151,4121,5272,1.4,50,0
17,82287,-2889,2321,5210,4.0,50,0
18,66056,-16765,325,17090,0.0,50,0
19,65667,-966,1381,2347,5.7,50,0
20,65753,-119,1546,1665,1.2,50,0
21,65453,-524,2131,2655,4.0,50,0
22,65868,207,3023,2816,0.7,50,0
23,76717,9846,12239,2393,0.5,50,0
24,76717,9846,12239,2393,0.4,50,0
0,1400435,0,0,0,2.3,45,0
1,1423373,-49369,83896,133265,1.3,45,0
2,1275332,-161277,55961,217238,1.5,45,0
3,1331722,27560,80072,52512,2.0,45,0
4,1379113,30596,135845,105249,2.0,45,0
5,1369688,-19483,64750,84233,1.5,45,0
6,1405724,25121,49839,24718,5.4,45,0
7,1458520,43791,69506,25715,1.9,45,0
8,1498709,36083,75156,39073,5.9,45,0
9,1531860,28605,47742,19137,2.3,45,0
10,1668694,117781,136037,18256,2.7,46,1
11,1704504,33836,52340,18504,0.4,46,0
12,1700541,938,26811,25873,3.1,46,0
13,1703234,-2328,30744,33072,2.4,46,0
14,1765544,50981,72325,21344,1.2,46,0
15,1783350,14975,43835,28860,2.8,47,1
16,1781315,-3348,55158,58506,0.0,47,0
17,1480768,-97786,40864,138650,2.0,47,0
18,1520287,-15335,51047,66382,1.2,47,0
19,1490480,-30529,17096,47625,2.7,46,-1
20,1461178,-31075,11691,42766,3.3,46,0
21,1414102,-48873,15987,64860,1.2,46,0
22,1315117,-91504,13437,104941,1.6,45,-1
23,1316683,-9974,34135,44109,1.3,45,0
24,1316683,-9974,34135,44109,3.6,45,0
0,269424,0,0,0,2.3,45,0
1,280163,-7479,29472,36951,1.4,45,0
2,250869,-31587,17665,49252,2.3,45,0
3,242269,-12121,13072,25193,9.2,45,0
4,281024,27999,68733,40734,1.8,45,0
5,318842,33332,63405,30073,5.1,45,0
6,342308,22556,42658,20102,2.0,45,0
7,341191,-824,27562,28386,7.9,45,0
8,336906,-4215,28628,32843,3.7,45,0
9,348842,8359,26900,18541,2.1,45,0
10,344797,-3850,25491,29341,3.5,45,0
11,343288,-2537,18177,20714,5.7,45,0
12,372407,27204,38234,11030,3.9,45,0
13,376782,4369,21128,16759,3.1,45,0
14,324410,-49871,8708,58579,0.0,45,0
15,330265,1715,17818,16103,3.0,45,0
16,335227,4123,26447,22324,0.0,45,0
17,254244,-40608,3532,44140,0.0,45,0
18,223133,-38127,1309,39436,0.0,45,0
19,191783,-31668,392,32060,2.2,45,0
20,175032,-17049,219,17268,0.0,45,0
21,160852,-14205,74,14279,2.8,45,0
22,151948,-8708,1301,10009,1.4,45,0
23,148184,-4407,1626,6033,1.1,45,0
24,148184,-4407,1626,6033,2.4,45,0
0,54083,0,0,0,3.7,65,0
1,39617,-18613,1322,19935,0.0,65,0
2,20292,-19857,9744,29601,0.0,64,-1
3,16700,-4342,616,4958,1.1,64,0
4,16121,-1092,853,1945,1.4,64,0
5,15953,-429,712,1141,4.3,64,0
6,16928,642,1574,932,0.0,64,0
7,16722,-410,1214,1624,1.3,64,0
8,16078,-799,842,1641,0.0,64,0
9,14758,-1368,277,1645,0.0,64,0
10,13418,-1330,35,1365,0.5,64,0
11,13740,155,648,493,5.1,64,0
12,15569,1684,2124,440,1.4,64,0
13,15891,262,1128,866,2.1,64,0
14,14986,-969,789,1758,0.0,64,0
15,14135,-875,26,901,0.0,64,0
16,13434,-716,22,738,0.0,64,0
17,12582,-264,23,287,0.0,64,0
18,12322,-294,77,371,0.3,64,0
19,12356,-20,110,130,8.8,64,0
20,12466,51,205,154,1.6,64,0
21,12623,67,315,248,6.1,64,0
22,12711,-9,334,343,7.0,64,0
23,14448,1532,1962,430,3.2,64,0
24,14448,1532,1962,430,2.4,64,0
0,1467030,0,0,0,8.0,85,0
1,1228417,-311008,26313,337321,10.6,85,0
2,1213775,-76714,101457,178171,6.9,84,-1
3,1480751,208787,282902,74115,5.6,85,1
4,1312469,-153461,73937,227398,9.8,85,0
5,1309954,-27129,83833,110962,8.4,85,0
6,1388488,62784,105584,42800,7.7,85,0
7,793493,-574638,25422,600060,0.0,84,-1
8,486900,-317631,1737,319368,0.0,83,-1
9,432811,-67564,548,68112,0.0,83,0
10,411580,-22616,7975,30591,8.8,83,0
11,581781,154058,166036,11978,13.2,83,0
12,632656,54508,73077,18569,0.9,84,1
13,620139,-9853,34009,43862,3.2,84,0
14,459212,-158329,5857,164186,0.0,83,-1
15,423045,-40187,909,41096,0.1,83,0
16,430091,4643,21125,16482,9.3,83,0
17,503740,14177,89469,75292,0.0,83,0
18,596390,85030,132647,47617,8.2,83,0
19,743864,142253,166140,23887,7.0,84,1
20,795668,50334,92665,42331,1.1,84,0
21,793628,-5561,52661,58222,9.2,84,0
22,750432,-43334,68367,111701,8.9,84,0
23,1385122,616273,644025,27752,0.0,85,1
24,1385122,616273,644025,27752,1.9,85,0
0,30741,0,0,0,3.7,50,0
1,29644,-4501,580,5081,1.1,50,0
2,25717,-4710,699,5409,0.0,50,0
3,22588,-3652,465,4117,0.0,49,-1
4,19663,-3282,227,3509,0.0,49,0
5,17934,-2053,174,2227,0.0,48,-1
6,16722,-1415,254,1669,1.2,48,0
7,15979,-919,432,1351,4.2,48,0
8,16754,350,1195,845,0.0,48,0
9,16230,-590,353,943,0.0,48,0
10,15655,-720,362,1082,0.0,47,-1
11,15119,-664,168,832,0.0,47,0
12,14561,-628,113,741,0.0,47,0
13,14136,-502,103,605,0.0,47,0
14,13907,-380,326,706,2.5,46,-1
15,15388,1296,1622,326,4.8,46,0
16,16675,1192,2000,808,5.6,46,0
17,22026,2842,4851,2009,2.3,46,0
18,27908,5317,8428,3111,2.2,46,0
19,27494,-318,1929,2247,3.3,46,0
20,26579,-988,612,1600,2.7,46,0
21,25050,-1645,666,2311,1.4,46,0
22,23241,-1759,314,2073,0.0,46,0
23,22826,-657,704,1361,0.0,46,0
24,22826,-657,704,1361,0.0,46,0
0,23082,0,0,0,0.0,55,0
1,14609,-8502,198,8700,2.3,55,0
2,14266,-1291,1843,3134,2.8,55,0
3,16374,1387,3219,1832,6.2,55,0
4,13381,-3016,972,3988,0.0,55,0
5,11565,-1965,123,2088,5.9,55,0
6,12473,515,1388,873,3.5,55,0
7,14882,1897,2886,989,8.4,55,0
8,43910,24367,29310,4943,2.6,55,0
9,50036,6996,12433,5437,2.5,55,0
10,54268,3471,11508,8037,5.6,55,0
11,51539,-2560,4059,6619,6.1,55,0
12,60031,7701,11124,3423,1.4,55,0
13,57195,-2901,3693,6594,0.0,55,0
14,47602,-9624,3154,12778,1.8,55,0
15,47067,-1349,2524,3873,0.2,55,0
16,41912,-5295,1181,6476,3.5,55,0
17,35005,-2968,1257,4225,3.8,55,0
18,33156,-2566,1195,3761,10.6,55,0
19,33042,-396,1775,2171,8.6,55,0
20,32203,-1001,1188,2189,0.0,55,0
21,26932,-5301,428,5729,0.0,55,0
22,23294,-3675,373,4048,5.4,55,0
23,32806,8460,10013,1553,0.0,55,0
24,32806,8460,10013,1553,5.5,55,0
0,36388,0,0,0,3.2,45,0
1,37373,-3763,1634,5397,0.0,45,0
2,32864,-5509,919,6428,3.3,45,0
3,34530,11,1960,1949,1.2,45,0
4,38905,2616,5584,2968,6.8,45,0
5,117128,65537,75194,9657,5.3,45,0
6,223240,99018,105529,6511,7.3,45,0
7,460369,213969,223926,9957,3.8,46,1
8,733493,254432,276555,22123,3.0,47,1
9,752027,36453,61122,24669,1.1,47,0
10,833317,68722,94156,25434,8.6,48,1
11,1001949,156496,170759,14263,2.9,48,0
12,1126371,125866,140402,14536,4.3,49,1
13,1233843,105472,131447,25975,5.3,50,1
14,1211142,-20982,102493,123475,0.0,50,0
15,723138,-486634,2031,488665,0.0,49,-1
16,484553,-246223,1087,247310,0.0,48,-1
17,307716,-61340,431,61771,0.0,48,0
18,267749,-47139,1084,48223,0.0,47,-1
19,245297,-22941,546,23487,0.0,47,0
20,228652,-16873,483,17356,0.0,47,0
21,213428,-15400,649,16049,6.8,47,0
22,217538,3341,11185,7844,1.8,47,0
23,257742,38156,47338,9182,2.4,47,0
24,257742,38156,47338,9182,4.3,47,0
0,280881,0,0,0,2.8,60,0
1,247080,-43431,8000,51431,7.1,60,0
2,195769,-54820,6038,60858,1.7,59,-1
3,182780,-16855,9227,26082,5.6,59,0
4,148113,-34625,2300,36925,1.9,58,-1
5,131902,-17855,1943,19798,11.0,58,0
6,151924,15915,22669,6754,13.9,58,0
7,534013,348885,362119,13234,5.6,59,1
8,497927,-9036,111067,120103,2.0,60,1
9,540026,27878,80121,52243,10.4,60,0
10,946651,366291,389231,22940,6.7,61,1
11,1234364,303262,335354,32092,9.6,62,1
12,1401251,176477,239206,62729,5.2,63,1
13,1378449,-24734,97458,122192,5.3,63,0
14,1391878,4632,130420,125788,4.3,63,0
15,1346373,-48726,56128,104854,3.2,63,0
16,1174491,-173712,30726,204438,4.1,63,0
17,863547,-137714,26678,164392,2.4,62,-1
18,810167,-79321,31474,110795,8.3,61,-1
19,742796,-68885,14810,83695,6.6,61,0
20,683859,-60398,8873,69271,3.2,60,-1
21,625988,-59628,12092,71720,11.3,60,0
22,612918,-13215,35854,49069,2.6,60,0
23,709815,86818,126599,39781,2.9,60,0
24,709815,86818,126599,39781,5.3,60,0
0,748080,0,0,0,4.7,45,0
1,702353,-69696,29779,99475,4.6,45,0
2,685330,-34442,75246,109688,1.6,45,0
3,744822,43503,86275,42772,2.5,45,0
4,787702,38507,117862,79355,4.6,45,0
5,774462,-15319,37452,52771,2.0,45,0
6,801021,20542,39284,18742,2.4,45,0
7,803402,616,31312,30696,3.6,45,0
8,892985,79840,107928,28088,2.5,46,1
9,904034,15335,35914,20579,4.5,46,0
10,964835,50743,70788,20045,3.2,46,0
11,1007596,38896,56560,17664,1.7,46,0
12,1011200,6507,26453,19946,3.5,47,1
13,1009330,-4055,24253,28308,4.4,47,0
14,1080041,61118,85120,24002,3.6,47,0
15,1157550,74105,97855,23750,3.6,48,1
16,1157970,1816,54654,52838,5.2,48,0
17,1007498,-82261,35400,117661,3.1,48,0
18,929972,-111329,25780,137109,0.0,48,0
19,723859,-205033,832,205865,0.0,48,0
20,569562,-156260,314,156574,0.0,47,-1
21,486478,-84177,595,84772,0.0,47,0
22,462356,-23702,12030,35732,2.1,47,0
23,413720,-50243,7786,58029,0.0,47,0
24,413720,-50243,7786,58029,0.0,47,0
0,196908,0,0,0,1.0,45,0
1,173374,-27099,2287,29386,1.4,45,0
2,147219,-27904,1959,29863,3.0,45,0
3,154299,2402,11046,8644,2.8,45,0
4,158031,1980,15164,13184,2.3,45,0
5,152499,-5949,5411,11360,2.1,45,0
6,159172,4761,8790,4029,1.0,45,0
7,139106,-18637,1982,20619,5.2,45,0
8,144580,2880,8310,5430,2.1,45,0
9,144318,-61,4142,4203,9.4,45,0
10,245712,84099,88670,4571,1.4,45,0
11,268062,32940,42387,9447,5.6,45,0
12,349010,76503,82814,6311,2.4,46,1
13,398669,48885,63272,14387,0.9,46,0
14,545357,133470,149532,16062,3.4,47,1
15,844879,294066,306029,11963,2.7,48,1
16,968435,126911,165269,38358,2.3,49,1
17,969831,-10974,80121,91095,2.4,49,0
18,1029702,25601,94094,68493,1.8,49,0
19,995117,-34892,33646,68538,4.9,49,0
20,965347,-31279,18812,50091,0.4,49,0
21,725124,-239701,5353,245054,1.5,49,0
22,629805,-91117,7760,98877,1.5,49,0
23,623986,-15382,29200,44582,1.7,49,0
24,623986,-15382,29200,44582,2.7,49,0
0,279992,0,0,0,3.9,60,0
1,251773,-40136,18737,58873,10.0,60,0
2,169745,-84620,11853,96473,4.2,59,-1
3,160259,-13409,17087,30496,3.2,59,0
4,103816,-56088,2880,58968,12.5,58,-1
5,123271,14015,29223,15208,8.0,58,0
6,162326,35225,46436,11211,3.5,58,0
7,247952,76819,91348,14529,9.8,58,0
8,349725,93593,130390,36797,8.3,59,1
9,380667,32169,57088,24919,3.6,59,0
10,601149,191523,221883,30360,1.8,60,1
11,527827,-48627,37793,86420,14.7,60,0
12,549147,15718,49703,33985,4.6,60,0
13,562657,11959,49384,37425,4.7,60,0
14,738680,161045,197540,36495,1.3,61,1
15,738740,4477,70547,66070,4.5,61,0
16,659748,-79131,36737,115868,0.0,61,0
17,457370,-78666,41949,120615,2.7,60,-1
18,438091,-31484,38328,69812,5.7,60,0
19,416088,-23271,28377,51648,7.2,59,-1
20,378414,-38466,16930,55396,2.5,59,0
21,350518,-29174,16216,45390,6.4,58,-1
22,374060,21606,60998,39392,0.5,58,0
23,435889,58838,93279,34441,0.0,58,0
24,435889,58838,93279,34441,5.9,58,0
0,23808,0,0,0,0.5,45,0
1,36698,5527,12240,6713,0.6,45,0
2,39762,809,8507,7698,0.0,45,0
3,36175,-3339,1615,4954,0.0,45,0
4,31028,-5247,481,5728,0.0,45,0
5,28184,-3130,195,3325,0.0,45,0
6,24370,-3893,32,3925,0.0,45,0
7,21732,-2660,60,2720,0.0,45,0
8,19147,-2521,38,2559,0.0,45,0
9,18449,-920,33,953,0.0,45,0
10,17494,-944,62,1006,0.0,45,0
11,17081,-561,49,610,0.0,45,0
12,16684,-435,51,486,0.0,45,0
13,16287,-437,72,509,0.0,44,-1
14,16073,-294,257,551,0.0,44,0
15,15767,-328,121,449,0.0,44,0
16,15281,-501,140,641,0.0,44,0
17,14214,-456,100,556,2.2,44,0
18,13520,-744,101,845,0.0,44,0
19,12938,-593,55,648,0.0,44,0
20,12566,-387,71,458,0.0,44,0
21,12185,-384,47,431,0.0,44,0
22,11833,-345,42,387,0.0,44,0
23,11664,-187,61,248,0.0,44,0
24,11664,-187,61,248,0.0,44,0
0,158019,0,0,0,0.0,50,0
1,159368,-14147,17515,31662,0.0,50,0
2,131923,-30763,9259,40022,0.1,49,-1
3,118267,-17713,6295,24008,0.0,49,0
4,102717,-17354,4508,21862,0.0,48,-1
5,97237,-7552,4980,12532,0.0,48,0
6,89478,-8466,1538,10004,0.0,48,0
7,84537,-5404,1525,6929,0.0,47,-1
8,79646,-5452,2082,7534,0.0,47,0
9,77747,-2471,1305,3776,0.0,47,0
10,76145,-2036,2071,4107,0.0,47,0
11,75039,-1432,1954,3386,0.0,47,0
12,74230,-1082,1334,2416,0.0,46,-1
13,73096,-1318,1210,2528,0.0,46,0
14,72771,-821,2330,3151,0.0,46,0
15,72179,-778,1064,1842,0.0,46,0
16,71448,-944,1331,2275,0.0,46,0
17,67161,-1602,290,1892,0.0,46,0
18,64608,-2654,317,2971,0.0,46,0
19,63392,-1296,243,1539,0.0,46,0
20,62186,-1241,256,1497,0.0,46,0
21,60504,-1669,132,1801,0.0,46,0
22,58946,-1569,142,1711,0.0,46,0
23,58085,-910,166,1076,0.0,46,0
24,58085,-910,166,1076,0.0,46,0
0,5118,0,0,0,0.4,55,0
1,4746,-1035,127,1162,2.1,55,0
2,9556,3336,5549,2213,0.9,55,0
3,12534,2317,4318,2001,5.3,55,0
4,9560,-2878,1833,4711,0.0,55,0
5,6658,-3070,92,3162,0.0,55,0
6,5246,-1531,27,1558,0.0,55,0
7,5046,-304,189,493,5.6,54,-1
8,5275,122,473,351,3.7,54,0
9,5320,6,259,253,4.0,54,0
10,7786,2123,2555,432,1.0,54,0
11,7385,-254,654,908,0.0,54,0
12,6687,-716,254,970,2.3,54,0
13,6219,-511,182,693,0.7,54,0
14,6230,-96,495,591,0.0,54,0
15,5945,-303,131,434,2.7,54,0
16,5617,-347,116,463,0.3,54,0
17,4737,-341,14,355,0.0,54,0
18,4398,-362,25,387,0.0,54,0
19,4297,-114,21,135,1.4,54,0
20,4293,-21,57,78,1.2,54,0
21,4335,18,123,105,0.0,54,0
22,4238,-132,58,190,0.3,54,0
23,4284,18,98,80,1.8,54,0
24,4284,18,98,80,0.3,54,0
0,22240,0,0,0,0.0,45,0
1,18707,-4712,336,5048,0.0,45,0
2,13625,-5165,136,5301,0.0,44,-1
3,11675,-2186,74,2260,0.0,44,0
4,9788,-1933,139,2072,0.0,44,0
5,8698,-1155,43,1198,0.0,43,-1
6,7934,-811,43,854,0.0,43,0
7,7308,-622,35,657,0.0,43,0
8,6776,-535,43,578,0.0,43,0
9,6492,-296,20,316,0.0,43,0
10,6152,-332,10,342,0.0,43,0
11,6113,-96,83,179,0.0,43,0
12,6088,-59,71,130,0.0,43,0
13,6044,-80,56,136,0.0,43,0
14,6070,-45,166,211,0.0,43,0
15,6018,-67,57,124,0.0,43,0
16,5963,-90,51,141,0.0,43,0
17,5656,-112,9,121,0.0,43,0
18,5503,-166,33,199,0.0,43,0
19,5409,-96,22,118,0.0,43,0
20,5340,-70,18,88,0.0,43,0
21,5290,-54,23,77,0.0,43,0
22,5357,20,92,72,1.0,43,0
23,5633,229,348,119,1.7,43,0
24,5633,229,348,119,1.9,43,0
0,0,0,0,0,0.0,40,0
1,70348,25232,29414,4182,0.0,40,0
2,125720,36105,46576,10471,0.0,40,0
3,149378,16373,24201,7828,0.0,40,0
4,197881,40852,53576,12724,0.0,40,0
5,231177,30569,37669,7100,0.0,40,0
6,239762,8070,13465,5395,0.0,40,0
7,248161,6697,12783,6086,0.0,40,0
8,275119,23344,30660,7316,0.0,40,0
9,282452,6798,11289,4491,0.0,40,0
10,282993,-778,10264,11042,0.0,40,0
11,287464,4194,9940,5746,0.0,40,0
12,290608,2067,6617,4550,0.0,40,0
13,292681,1687,6656,4969,0.0,40,0
14,300514,5764,11437,5673,0.0,40,0
15,302269,1568,7494,5926,0.0,40,0
16,299031,-3712,9736,13448,1.2,40,0
17,490524,77260,99485,22225,0.0,40,0
18,480325,32971,55357,22386,0.0,40,0
19,498215,16564,28801,12237,0.0,40,0
20,508557,8888,20073,11185,0.0,40,0
21,497206,-11681,11063,22744,0.0,40,0
22,477169,-19724,10665,30389,0.0,40,0
23,469327,-9741,9157,18898,0.0,40,0
24,469327,-9741,9157,18898,0.0,40,0
0,0,0,0,0,0.0,45,0
1,13086,4514,6569,2055,0.2,45,0
2,27648,7704,13058,5354,0.3,45,0
3,26122,-732,2787,3519,0.0,45,0
4,23562,-2550,426,2976,0.2,45,0
5,22874,-1067,476,1543,0.0,45,0
6,31521,5883,8205,2322,0.0,44,-1
7,35570,3104,6428,3324,0.0,44,0
8,39851,3036,7245,4209,0.0,44,0
9,38435,-504,2097,2601,0.0,44,0
10,36217,-1974,945,2919,0.0,44,0
11,34933,-1425,526,1951,0.0,44,0
12,34317,-777,451,1228,0.0,44,0
13,33682,-724,493,1217,0.0,44,0
14,33533,-425,1304,1729,0.0,44,0
15,32827,-693,247,940,0.0,44,0
16,31618,-1263,270,1533,0.0,44,0
17,29135,-1139,111,1250,0.0,44,0
18,27317,-1924,45,1969,0.0,44,0
19,26034,-1307,29,1336,0.0,44,0
20,25067,-983,18,1001,0.0,44,0
21,24199,-894,130,1024,0.0,43,-1
22,24054,-273,543,816,0.0,43,0
23,23899,-222,433,655,0.0,43,0
24,23899,-222,433,655,2.5,43,0
0,454,307,415,108,1.3,45,0
1,886,318,457,139,0.7,45,0
2,1140,185,325,140,0.0,45,0
3,1037,-125,156,281,0.0,45,0
4,1219,64,251,187,0.1,45,0
5,1298,26,143,117,0.1,45,0
6,1420,63,222,159,0.0,45,0
7,1491,28,180,152,0.2,45,0
8,1516,18,122,104,0.0,45,0
9,1475,-54,83,137,0.0,45,0
10,1698,124,326,202,1.3,45,0
11,1898,165,273,108,0.0,45,0
12,1779,-128,86,214,1.3,45,0
13,2548,163,402,239,1.3,45,0
14,2825,204,590,386,1.9,45,0
15,2783,-60,271,331,4.1,45,0
16,2398,-386,40,426,0.0,45,0
17,2059,-341,20,361,0.0,45,0
18,1794,-274,19,293,0.0,45,0
19,1685,-115,34,149,0.0,45,0
20,1685,-115,34,149,0.0,45,0
0,0,0,0,0,0.0,45,0
1,3338,2506,3037,531,0.0,45,0
2,3431,30,896,866,0.0,45,0
3,4710,542,1703,1161,0.0,45,0
4,5007,225,969,744,0.0,45,0
5,6714,1015,2111,1096,0.0,45,0
6,7292,568,1812,1244,0.3,45,0
7,8745,1032,2050,1018,0.0,45,0
8,8771,8,1461,1453,0.0,45,0
9,10902,1453,3244,1791,0.0,45,0
10,11178,217,1413,1196,0.0,45,0
11,11334,3,1547,1544,0.5,45,0
12,18321,3135,5501,2366,1.7,45,0
13,17767,1006,4672,3666,0.4,45,0
14,19989,1986,4144,2158,0.0,45,0
15,19602,-407,2091,2498,0.0,45,0
16,18292,-1429,1171,2600,0.2,45,0
17,18381,-293,2129,2422,0.0,45,0
18,18394,-86,1833,1919,0.0,45,0
19,18394,-86,1833,1919,0.0,45,0
0,0,0,0,0,0.0,40,0
1,1480,695,846,151,0.0,40,0
2,2000,279,473,194,0.0,40,0
3,2566,210,498,288,0.0,40,0
4,3036,188,481,293,0.0,40,0
5,3459,211,515,304,0.0,40,0
6,3938,274,667,393,0.0,40,0
7,4485,93,764,671,0.0,40,0
8,4614,-8,317,325,0.0,40,0
9,4711,-67,285,352,0.0,40,0
10,5298,49,273,224,0.0,40,0
11,5368,-115,295,410,0.0,40,0
12,5371,-97,155,252,0.0,40,0
13,5377,-116,135,251,1.3,40,0
14,5761,160,496,336,0.0,40,0
15,6157,78,480,402,0.0,40,0
16,6391,65,382,317,0.0,40,0
17,6391,65,382,317,0.0,40,0
0,0,0,0,0,0.0,45,0
1,118,32,43,11,0.0,45,0
2,155,8,35,27,0.0,45,0
3,161,-8,11,19,0.0,45,0
4,169,-4,18,22,0.0,45,0
5,181,-2,15,17,0.0,45,0
6,208,-3,23,26,0.0,44,-1
7,331,84,134,50,0.0,44,0
8,331,84,134,50,0.0,44,0
0,0,0,0,0,0.0,40,0
1,1915,623,781,158,0.0,40,0
2,1828,272,474,202,0.0,40,0
3,2086,195,294,99,0.0,40,0
4,2303,159,259,100,0.0,40,0
5,2387,14,189,175,0.0,40,0
6,2384,-92,151,243,0.0,40,0
7,2508,46,194,148,0.0,40,0
8,2508,46,194,148,0.0,40,0
0,0,0,0,0,0.0,45,0
1,53,24,40,16,0.0,45,0
2,66,-1,12,13,0.0,45,0
3,91,8,23,15,0.0,45,0
4,124,9,23,14,0.0,45,0
5,140,-9,18,27,0.0,45,0
6,162,5,18,13,0.0,45,0
7,162,5,18,13,0.0,45,0
0,0,0,0,0,0.0,40,0
1,241,73,96,23,0.0,40,0
2,347,39,69,30,0.0,40,0
3,451,19,63,44,0.0,40,0
4,621,75,135,60,0.0,40,0
5,800,-5,117,122,0.0,40,0
6,937,51,136,85,0.0,40,0
7,937,51,136,85,0.0,40,0
0,0,0,0,0,0.0,45,0
1,111,67,98,31,0.5,45,0
2,146,20,52,32,0.0,45,0
3,193,27,52,25,0.0,45,0
4,219,9,41,32,0.0,45,0
5,255,5,49,44,0.0,45,0
6,274,3,44,41,0.0,45,0
7,274,3,44,41,0.0,45,0
0,0,0,0,0,0.0,45,0
1,28,14,18,4,0.5,45,0
2,65,23,32,9,0.0,45,0
3,115,38,76,38,0.0,45,0
4,160,27,74,47,0.0,45,0
5,236,29,73,44,0.0,45,0
6,236,29,73,44,0.0,45,0
0,0,0,0,0,0.0,45,0
1,40,23,29,6,0.0,45,0
2,69,10,32,22,0.0,45,0
3,106,14,32,18,0.0,45,0
4,106,14,32,18,0.0,45,0
0,296409,0,0,0,2.0,55,0
1,319315,-18999,13398,32397,3.7,55,0
2,361182,6565,43905,37340,0.2,55,0
3,330050,-30652,8428,39080,0.6,55,0
4,419844,58608,87126,28518,1.7,55,0
5,413202,-5726,24854,30580,1.5,55,0
6,419798,870,15972,15102,1.1,55,0
7,424304,-2285,14944,17229,1.8,55,0
8,395062,-26418,6060,32478,3.4,55,0
9,399842,-2882,14175,17057,1.9,55,0
10,443690,31837,53637,21800,1.7,55,0
11,505870,51759,64027,12268,2.4,55,0
12,504498,-2107,16523,18630,7.0,56,1
13,536608,24011,33490,9479,1.8,56,0
14,541213,-765,21132,21897,4.0,56,0
15,550062,-12379,13986,26365,3.5,56,0
16,883752,75113,105096,29983,2.2,56,0
17,585592,-32761,13967,46728,2.5,56,0
18,568408,-34577,7442,42019,3.2,56,0
19,569246,-2274,13778,16052,1.5,56,0
20,543224,-26013,2224,28237,1.2,56,0
21,556589,8648,24427,15779,1.0,56,0
22,513404,-40484,4428,44912,2.2,56,0
23,501770,-16243,6308,22551,2.0,56,0
24,522566,15813,37509,21696,2.6,56,0
0,33970,0,0,0,0.7,50,0
1,37035,-4149,2277,6426,0.0,50,0
2,32482,-6573,2162,8735,0.0,49,-1
3,28150,-5323,1114,6437,3.0,49,0
4,29221,-639,3324,3963,4.1,48,-1
5,30985,739,3624,2885,0.8,48,0
6,31907,292,2650,2358,0.7,48,0
7,32233,-126,2325,2451,0.7,48,0
8,32667,-401,2313,2714,0.9,48,0
9,33949,714,2581,1867,0.6,48,0
10,34749,199,2474,2275,0.6,48,0
11,35790,740,2738,1998,1.8,48,0
12,36296,227,1828,1601,0.9,48,0
13,36954,351,2132,1781,1.2,48,0
14,39302,1563,4167,2604,0.4,48,0
15,38244,-1063,1231,2294,0.2,48,0
16,40061,-372,3379,3751,6.4,48,0
17,37379,-1060,1117,2177,0.0,48,0
18,35608,-2273,738,3011,0.0,48,0
19,34055,-1730,268,1998,3.7,48,0
20,33376,-866,306,1172,2.9,48,0
21,32707,-864,319,1183,0.0,48,0
22,31699,-1126,377,1503,0.8,48,0
23,31185,-705,220,925,0.0,47,-1
24,30934,-435,488,923,0.0,47,0
0,166187,0,0,0,3.0,55,0
1,181839,-10421,9316,19737,0.0,55,0
2,167709,-23668,11803,35471,0.0,55,0
3,140085,-30201,2026,32227,0.0,54,-1
4,127143,-16187,3261,19448,2.9,54,0
5,124622,-4411,3722,8133,4.5,54,0
6,131832,4735,8920,4185,1.6,54,0
7,136090,2013,6972,4959,3.5,54,0
8,139069,1654,8564,6910,3.2,54,0
9,120714,-17720,1857,19577,0.0,54,0
10,107925,-13303,282,13585,2.4,54,0
11,118485,7634,9984,2350,3.8,54,0
12,119572,961,3545,2584,3.6,54,0
13,124285,3730,5829,2099,4.4,54,0
14,126361,872,6167,5295,0.0,54,0
15,129312,-1632,2971,4603,9.5,54,0
16,233175,36389,45607,9218,0.0,54,0
17,152644,-12857,2679,15536,0.0,54,0
18,141133,-14916,1793,16709,0.0,54,0
19,137024,-4875,2373,7248,4.2,54,0
20,134026,-3446,1219,4665,1.5,54,0
21,138425,2930,6859,3929,3.5,54,0
22,135286,-3370,3441,6811,0.0,54,0
23,133319,-2797,2467,5264,0.0,54,0
24,134321,-27,6547,6574,2.3,54,0
0,10931,0,0,0,0.0,60,0
1,10827,-2326,582,2908,3.7,60,0
2,11749,-561,1551,2112,1.2,59,-1
3,13578,451,2433,1982,3.5,59,0
4,15147,170,3217,3047,0.0,59,0
5,12875,-2437,557,2994,6.0,59,0
6,12716,-631,707,1338,0.5,59,0
7,11598,-1258,514,1772,0.0,58,-1
8,9757,-1851,55,1906,0.0,58,0
9,9265,-568,32,600,0.0,58,0
10,8866,-423,51,474,0.0,58,0
11,8585,-300,22,322,0.0,57,-1
12,8418,-169,15,184,0.0,57,0
13,8300,-125,14,139,0.0,57,0
14,8261,-99,103,202,0.0,57,0
15,8550,14,139,125,0.0,57,0
16,8700,-83,176,259,0.3,57,0
17,8650,-39,57,96,0.0,57,0
18,8651,-124,66,190,0.5,57,0
19,8663,-49,70,119,2.0,57,0
20,8678,-48,52,100,1.8,57,0
21,8893,97,205,108,3.0,57,0
22,9035,5,224,219,0.4,57,0
23,9179,24,216,192,5.1,57,0
24,9666,317,587,270,0.2,57,0
0,894557,0,0,0,5.2,105,0
1,829125,-140554,39756,180310,18.4,105,0
2,1243962,266301,355042,88741,19.1,105,0
3,1208153,-37357,123780,161137,19.6,105,0
4,2083949,723621,769600,45979,20.5,106,1
5,2874709,765946,783764,17818,6.9,108,1
6,3137021,252287,270201,17914,6.7,109,1
7,3370292,194924,214170,19246,17.8,110,1
8,3342613,-24064,143251,167315,4.3,110,0
9,3210982,-142038,62167,204205,4.2,110,0
10,2928321,-264317,65490,329807,11.1,109,-1
11,3116271,106446,164995,58549,11.3,109,0
12,3131857,21480,77852,56372,0.8,109,0
13,3290617,134670,164460,29790,5.5,110,1
14,3209230,-86077,82885,168962,3.6,110,0
15,3264888,-19026,79446,98472,13.0,110,0
16,4087630,251254,325776,74522,8.9,110,0
17,3221390,-208661,86391,295052,15.5,111,1
18,3769605,399757,458404,58647,0.0,112,1
19,2453093,-1299896,91139,1391035,0.0,112,0
20,1665524,-797821,2695,800516,0.0,111,-1
21,1396326,-276543,4746,281289,13.1,110,-1
22,1766120,345089,397573,52484,3.6,110,0
23,2020394,250424,291195,40771,7.5,110,0
24,2632864,570891,615011,44120,10.3,111,1
0,236728,0,0,0,0.0,55,0
1,171292,-73290,3206,76496,0.0,54,-1
2,123513,-52114,2664,54778,0.0,53,-1
3,101336,-24948,1518,26466,14.1,52,-1
4,183752,59518,77204,17686,4.3,52,0
5,195046,14852,31700,16848,0.0,52,0
6,183797,-11516,11603,23119,0.0,52,0
7,145209,-38084,2740,40824,0.0,52,0
8,127562,-18941,1900,20841,2.9,52,0
9,130172,491,4714,4223,2.6,52,0
10,146807,12478,16629,4151,2.0,52,0
11,149474,3226,13935,10709,2.9,52,0
12,151918,1501,8074,6573,3.1,52,0
13,169349,15583,20037,4454,1.4,52,0
14,179015,8293,19665,11372,0.0,52,0
15,174463,-7941,4347,12288,0.0,52,0
16,166722,-13751,8070,21821,8.3,52,0
17,147010,-13666,1533,15199,7.9,52,0
18,142803,-7953,4288,12241,0.2,52,0
19,143618,60,5375,5315,0.0,52,0
20,136837,-6942,1423,8365,3.6,52,0
21,143016,4780,9432,4652,7.1,52,0
22,126549,-15332,843,16175,0.0,52,0
23,117758,-9549,583,10132,0.0,52,0
24,114374,-3781,3785,7566,4.0,52,0
0,1724987,0,0,0,9.6,90,0
1,1378891,-424230,60870,485100,24.8,89,-1
2,2405919,784722,918358,133636,5.2,91,1
3,1011225,-1308054,72111,1380165,20.6,90,-1
4,3165689,1907229,1991731,84502,15.2,92,1
5,3897415,746754,764606,17852,10.7,94,1
6,4291822,373225,384869,11644,2.1,95,1
7,4481515,161096,189010,27914,8.2,96,1
8,4208016,-261619,139447,401066,6.0,95,-1
9,4320890,68310,156002,87692,2.0,95,0
10,4309429,-27457,108890,136347,7.5,95,0
11,4587823,222898,251302,28404,6.0,96,1
12,4559057,-16425,92606,109031,8.2,96,0
13,4746191,154155,170409,16254,11.0,97,1
14,4754738,-7255,110504,117759,4.3,97,0
15,4863090,-18558,88545,107103,15.1,97,0
16,5186954,93260,181183,87923,7.3,98,1
17,4372039,-473686,38008,511694,9.7,97,-1
18,4644767,97186,229290,132104,3.3,97,0
19,4730468,75327,167978,92651,5.8,98,1
20,4479241,-254548,50580,305128,5.1,97,-1
21,4466780,-28456,146454,174910,10.4,97,0
22,4209287,-235319,64797,300116,1.7,96,-1
23,4124945,-125462,78291,203753,8.0,95,-1
24,4189610,45430,241107,195677,14.7,95,0
0,95090,0,0,0,1.8,50,0
1,106120,-5327,7555,12882,1.8,50,0
2,111525,-2740,14985,17725,1.9,50,0
3,106781,-7517,5957,13474,2.1,50,0
4,99469,-10843,11818,22661,0.0,50,0
5,80780,-18721,549,19270,1.9,50,0
6,87808,4035,9405,5370,2.0,49,-1
7,94740,4146,8366,4220,2.6,49,0
8,96852,1115,9379,8264,4.1,49,0
9,122314,21114,25622,4508,2.4,49,0
10,201005,64305,70195,5890,1.9,49,0
11,298185,95678,105026,9348,3.3,50,1
12,308692,13276,28985,15709,2.7,50,0
13,360165,47811,59018,11207,3.1,50,0
14,391134,28673,58595,29922,2.2,50,0
15,450786,-9013,22623,31636,4.0,51,1
16,688944,46958,83483,36525,3.1,51,0
17,408581,-66786,10007,76793,3.3,51,0
18,382961,-53701,6367,60068,2.4,51,0
19,373613,-11257,12508,23765,0.0,50,-1
20,341674,-32185,2965,35150,4.8,50,0
21,333021,-10751,12733,23484,0.0,50,0
22,269217,-60736,2810,63546,3.2,49,-1
23,259259,-14302,10731,25033,5.0,49,0
24,324492,59487,80848,21361,0.0,49,0
0,149187,0,0,0,4.4,70,0
1,147075,-17232,11143,28375,0.0,70,0
2,125870,-25581,6308,31889,14.1,69,-1
3,152068,16661,32185,15524,0.3,69,0
4,136288,-17707,12246,29953,0.0,69,0
5,121630,-16147,4169,20316,1.7,69,0
6,115265,-8062,3496,11558,0.0,69,0
7,106509,-9304,1870,11174,0.6,68,-1
8,100311,-7026,1271,8297,0.4,68,0
9,97309,-3622,770,4392,0.0,68,0
10,94530,-3209,816,4025,0.4,67,-1
11,92571,-2397,884,3281,0.0,67,0
12,91510,-1362,1022,2384,0.6,67,0
13,90846,-902,939,1841,2.2,67,0
14,89703,-1531,1147,2678,0.0,67,0
15,87133,-2220,197,2417,0.4,67,0
16,87446,-868,1181,2049,0.0,67,0
17,86136,-663,288,951,0.5,67,0
18,85494,-997,377,1374,0.0,67,0
19,85135,-524,327,851,2.4,67,0
20,84813,-492,261,753,0.8,66,-1
21,84818,-259,691,950,5.1,66,0
22,84784,-379,746,1125,0.2,66,0
23,84603,-457,488,945,9.5,66,0
24,91438,5929,7415,1486,8.7,66,0
0,237638,0,0,0,4.1,80,0
1,154269,-96227,7461,103688,0.0,79,-1
2,69953,-89124,2819,91943,0.0,77,-1
3,55400,-18416,2118,20534,0.7,76,-1
4,50193,-7752,1900,9652,0.0,76,0
5,47658,-3542,1278,4820,0.0,75,-1
6,45866,-2632,910,3542,0.0,75,0
7,44249,-2144,555,2699,0.0,75,0
8,43056,-1963,395,2358,0.0,74,-1
9,43028,-550,656,1206,0.0,74,0
10,42865,-716,590,1306,0.0,74,0
11,42476,-810,404,1214,0.4,74,0
12,42504,-252,371,623,0.0,74,0
13,42446,-314,274,588,0.0,74,0
14,42256,-643,374,1017,0.0,74,0
15,42369,-253,254,507,0.0,74,0
16,42641,-456,434,890,0.0,74,0
17,42303,-268,127,395,0.0,74,0
18,41821,-719,143,862,0.0,74,0
19,41419,-444,18,462,0.0,74,0
20,41126,-328,35,363,0.0,74,0
21,40770,-377,73,450,0.0,74,0
22,40542,-357,132,489,0.3,74,0
23,40775,-31,205,236,1.9,74,0
24,45802,4370,4899,529,2.0,74,0
0,155868,0,0,0,9.2,50,0
1,155739,-12410,13490,25900,0.6,50,0
2,142235,-19850,15628,35478,2.5,50,0
3,117844,-24434,2873,27307,1.1,49,-1
4,103036,-18380,8354,26734,0.0,49,0
5,84909,-18840,3016,21856,1.4,48,-1
6,91329,3995,10894,6899,0.2,48,0
7,86370,-5569,4498,10067,0.0,48,0
8,73515,-12425,1291,13716,0.0,48,0
9,66625,-7819,677,8496,0.0,47,-1
10,62046,-5017,688,5705,0.6,47,0
11,59104,-3544,612,4156,0.2,47,0
12,57024,-2332,362,2694,1.8,46,-1
13,56129,-1164,926,2090,0.0,46,0
14,54475,-2044,1183,3227,5.8,46,0
15,61049,685,2893,2208,5.0,46,0
16,112763,14433,20455,6022,0.0,46,0
17,66855,-7300,1307,8607,3.2,46,0
18,65031,-4056,1469,5525,1.6,46,0
19,64460,-816,2258,3074,3.0,46,0
20,63698,-966,1026,1992,1.3,46,0
21,66770,2504,4436,1932,1.7,46,0
22,65448,-1433,2738,4171,1.2,46,0
23,70326,4238,8138,3900,0.0,46,0
24,74856,3799,12894,9095,0.0,46,0
0,66864,0,0,0,2.0,50,0
1,62000,-9168,4352,13520,1.1,50,0
2,54887,-9098,5340,14438,5.8,49,-1
3,55108,-1613,7214,8827,5.9,49,0
4,59006,714,11209,10495,3.1,49,0
5,59980,-191,7258,7449,2.3,49,0
6,61562,566,6265,5699,1.8,49,0
7,60551,-1526,4579,6105,2.8,49,0
8,59000,-2416,4411,6827,2.0,49,0
9,62786,2533,6227,3694,1.7,49,0
10,66575,2527,7460,4933,2.8,49,0
11,73502,5969,10608,4639,2.0,49,0
12,75316,1534,5897,4363,1.4,49,0
13,75869,-30,5144,5174,3.2,49,0
14,78583,1555,7966,6411,1.3,49,0
15,75471,-2819,2822,5641,6.7,49,0
16,66252,-6682,4428,11110,2.7,49,0
17,65858,-3407,2008,5415,7.1,49,0
18,66328,-1035,4170,5205,6.7,49,0
19,67572,676,4333,3657,2.0,49,0
20,68250,93,3583,3490,1.4,49,0
21,67186,-1731,2543,4274,5.8,49,0
22,68591,556,5182,4626,1.6,49,0
23,67221,-1950,2516,4466,2.7,49,0
24,76489,7856,12751,4895,1.0,49,0
0,10287,0,0,0,0.4,55,0
1,11945,-1035,761,1796,1.2,55,0
2,11929,-1048,784,1832,3.8,55,0
3,11924,-712,786,1498,0.0,55,0
4,10997,-1325,421,1746,0.1,54,-1
5,10343,-834,170,1004,0.0,54,0
6,9729,-745,137,882,0.0,54,0
7,9190,-628,100,728,0.0,53,-1
8,8610,-668,110,778,0.0,53,0
9,8263,-390,107,497,0.0,52,-1
10,8261,-107,237,344,0.0,52,0
11,8133,-191,123,314,0.0,52,0
12,8053,-133,109,242,0.0,52,0
13,7978,-105,83,188,0.3,52,0
14,7948,-127,157,284,1.2,52,0
15,7977,-62,82,144,2.8,52,0
16,8166,-35,251,286,4.0,52,0
17,7998,-71,84,155,0.0,52,0
18,7950,-125,127,252,0.6,52,0
19,7913,-92,47,139,0.0,52,0
20,7888,-66,49,115,0.0,52,0
21,7875,-69,54,123,0.0,51,-1
22,7856,-91,77,168,0.0,51,0
23,7812,-81,46,127,0.0,51,0
24,7798,-54,90,144,0.0,51,0
0,62607,0,0,0,0.0,55,0
1,62588,-10521,1670,12191,1.1,55,0
2,66672,-2613,5021,7634,6.7,55,0
3,65080,-4008,1692,5700,5.0,54,-1
4,68827,114,5242,5128,1.5,54,0
5,68403,-1440,3535,4975,0.0,54,0
6,66996,-2421,2085,4506,0.0,54,0
7,63840,-3784,1251,5035,0.0,54,0
8,60366,-4179,798,4977,0.0,54,0
9,59242,-1802,1152,2954,0.0,53,-1
10,58330,-1547,1292,2839,0.0,53,0
11,56957,-1769,836,2605,0.0,53,0
12,55914,-1317,294,1611,0.0,53,0
13,55043,-1089,381,1470,0.0,53,0
14,54300,-1176,687,1863,2.3,53,0
15,54938,-274,574,848,0.0,53,0
16,54522,-1042,800,1842,2.4,52,-1
17,54228,-312,257,569,0.0,52,0
18,53836,-797,334,1131,0.0,52,0
19,53632,-373,205,578,2.0,52,0
20,53503,-297,193,490,0.0,52,0
21,53446,-306,389,695,1.5,52,0
22,54532,516,1297,781,2.7,52,0
23,55528,593,1580,987,3.2,52,0
24,59707,3410,4898,1488,3.1,52,0
0,83611,0,0,0,0.6,75,0
1,67770,-25656,3446,29102,1.1,74,-1
2,44979,-25569,1458,27027,4.7,73,-1
3,39308,-7795,2206,10001,0.0,72,-1
4,30571,-9284,706,9990,0.4,72,0
5,29511,-1878,850,2728,0.0,71,-1
6,28520,-1508,511,2019,0.0,71,0
7,27447,-1404,419,1823,0.0,71,0
8,25986,-1733,265,1998,0.7,70,-1
9,26478,44,741,697,2.2,70,0
10,27381,498,1431,933,2.0,70,0
11,28667,921,2017,1096,0.7,70,0
12,29235,382,1519,1137,1.3,70,0
13,31014,1521,2549,1028,0.0,70,0
14,30643,-810,1610,2420,0.1,70,0
15,30712,-337,954,1291,6.8,70,0
16,36636,1885,3988,2103,0.0,70,0
17,31198,-1894,333,2227,5.2,70,0
18,31207,-562,945,1507,4.9,70,0
19,31772,340,1200,860,2.1,70,0
20,31574,-374,748,1122,1.2,70,0
21,32932,937,2204,1267,0.1,70,0
22,31345,-1794,698,2492,0.0,70,0
23,30702,-941,359,1300,0.0,70,0
24,30721,-343,732,1075,0.0,70,0
0,8128,0,0,0,0.0,50,0
1,5422,-2868,65,2933,0.0,50,0
2,4221,-1385,76,1461,0.0,49,-1
3,4177,-309,194,503,0.0,49,0
4,4000,-362,165,527,0.0,49,0
5,3598,-402,20,422,0.0,49,0
6,3315,-317,10,327,0.0,49,0
7,3174,-155,14,169,0.0,49,0
8,3080,-115,38,153,0.0,49,0
9,3079,-34,52,86,0.0,49,0
10,3225,29,117,88,0.0,49,0
11,3316,-4,102,106,0.0,49,0
12,3368,-34,53,87,0.0,49,0
13,3214,-148,14,162,0.0,49,0
14,3108,-108,18,126,0.0,49,0
15,3221,13,63,50,0.0,49,0
16,3463,14,150,136,0.0,49,0
17,3413,-24,55,79,0.0,49,0
18,3483,-45,73,118,0.0,49,0
19,3544,-8,68,76,0.0,49,0
20,3607,8,64,56,0.0,49,0
21,3705,-2,77,79,0.0,49,0
22,3788,-22,97,119,1.9,49,0
23,3967,70,174,104,0.6,49,0
24,4219,135,297,162,0.0,49,0
0,55175,0,0,0,0.0,70,0
1,45404,-10831,741,11572,2.2,69,-1
2,42371,-5057,1653,6710,8.2,69,0
3,40903,-2478,1507,3985,0.0,69,0
4,35234,-5742,294,6036,0.0,69,0
5,33449,-2144,250,2394,3.8,69,0
6,32928,-858,291,1149,3.6,69,0
7,32522,-595,378,973,1.3,69,0
8,32222,-631,375,1006,5.7,69,0
9,33515,880,1567,687,0.2,69,0
10,33165,-525,572,1097,0.0,69,0
11,34235,771,1626,855,1.3,69,0
12,34925,552,1576,1024,4.9,69,0
13,36214,1078,1910,832,1.5,69,0
14,33456,-2755,422,3177,0.0,69,0
15,31540,-820,33,853,0.0,69,0
16,30642,-888,55,943,0.0,69,0
17,30425,-283,23,306,0.0,69,0
18,30005,-426,26,452,0.0,69,0
19,29802,-212,22,234,0.0,69,0
20,29606,-205,17,222,0.0,69,0
21,29411,-203,25,228,0.0,69,0
22,29190,-226,26,252,0.0,69,0
23,29064,-138,30,168,0.0,69,0
24,28950,-120,50,170,0.0,69,0
0,12879,0,0,0,0.5,60,0
1,14674,-1682,1261,2943,0.4,60,0
2,15690,-1369,2510,3879,1.1,60,0
3,16143,-927,1746,2673,10.2,59,-1
4,22838,3588,6220,2632,1.5,59,0
5,24417,627,3360,2733,4.8,59,0
6,26761,1263,3669,2406,1.1,59,0
7,26222,-1003,2238,3241,5.3,59,0
8,21913,-4391,475,4866,4.0,59,0
9,27397,4265,5517,1252,1.9,59,0
10,32472,3863,6265,2402,0.0,59,0
11,30203,-2277,2409,4686,6.6,59,0
12,31400,725,2583,1858,0.0,59,0
13,30704,-957,1574,2531,0.9,59,0
14,30010,-1292,1605,2897,7.8,59,0
15,38852,1660,4601,2941,4.8,59,0
16,49784,3689,9356,5667,5.0,59,0
17,39910,-3349,1950,5299,8.6,59,0
18,53636,9491,14655,5164,1.9,59,0
19,55670,1559,6258,4699,2.0,59,0
20,48532,-7204,1434,8638,0.6,59,0
21,46289,-2905,2422,5327,2.3,59,0
22,43503,-3327,1788,5115,4.2,59,0
23,41980,-2194,1148,3342,1.7,59,0
24,45715,2842,5698,2856,3.4,59,0
0,1485702,0,0,0,5.9,60,0
1,1368719,-180742,39131,219873,0.4,60,0
2,1155317,-242759,45516,288275,5.9,60,0
3,965580,-195429,10153,205582,0.0,59,-1
4,809078,-167597,16188,183785,0.0,59,0
5,672424,-140145,9182,149327,3.9,58,-1
6,652178,-27835,16073,43908,1.8,58,0
7,628408,-27243,12188,39431,6.5,58,0
8,530730,-89379,16860,106239,0.0,58,0
9,506424,-33068,4847,37915,0.0,58,0
10,491654,-17360,12283,29643,0.0,58,0
11,459079,-34158,5593,39751,0.0,58,0
12,432404,-27312,1424,28736,0.0,58,0
13,410332,-22927,1197,24124,0.0,57,-1
14,387456,-23087,2097,25184,2.1,57,0
15,378522,-6467,2074,8541,1.9,57,0
16,380944,-5019,6383,11402,0.0,57,0
17,365723,-7652,632,8284,0.0,57,0
18,351740,-15322,419,15741,0.5,57,0
19,348124,-4236,1908,6144,0.0,56,-1
20,344879,-3451,884,4335,0.0,56,0
21,342888,-2484,2589,5073,0.1,56,0
22,337676,-5246,1243,6489,0.0,56,0
23,335144,-3128,1334,4462,3.1,56,0
24,334817,-834,3738,4572,0.0,56,0
0,55692,0,0,0,0.0,45,0
1,61004,-4319,1549,5868,0.0,45,0
2,59018,-5316,1169,6485,0.0,45,0
3,57149,-3743,647,4390,0.0,45,0
4,55277,-3614,1440,5054,0.0,44,-1
5,53981,-2276,1008,3284,0.0,44,0
6,53188,-1406,629,2035,0.0,44,0
7,52208,-1320,489,1809,0.0,44,0
8,51377,-1357,523,1880,0.0,44,0
9,50714,-999,274,1273,0.0,44,0
10,50319,-813,692,1505,0.0,44,0
11,49431,-1122,370,1492,0.0,44,0
12,49081,-541,276,817,0.0,43,-1
13,48705,-513,347,860,0.0,43,0
14,48351,-677,443,1120,0.0,43,0
15,47663,-555,248,803,0.0,43,0
16,47027,-1070,513,1583,0.0,43,0
17,46509,-444,282,726,0.0,43,0
18,46215,-648,314,962,0.0,43,0
19,46128,-230,204,434,0.0,43,0
20,46117,-179,211,390,0.0,43,0
21,46209,-150,404,554,0.0,43,0
22,46208,-237,555,792,0.0,43,0
23,46050,-376,279,655,0.0,43,0
24,45896,-397,410,807,0.0,43,0
0,10638,8063,12364,4301,0.0,55,0
1,37537,19247,23523,4276,7.5,55,0
2,145131,84744,102512,17768,4.4,55,0
3,260793,109764,123530,13766,0.0,55,0
4,292851,31709,55273,23564,5.9,56,1
5,301748,6110,44689,38579,7.7,56,0
6,319132,11924,43622,31698,2.4,56,0
7,362670,38587,52911,14324,0.8,56,0
8,388217,23931,55695,31764,1.4,56,0
9,471904,68833,82405,13572,3.8,57,1
10,464868,-2338,21696,24034,0.5,57,0
11,477292,7785,27762,19977,2.6,57,0
12,487024,6713,44111,37398,3.2,57,0
13,532198,-5481,29070,34551,0.0,57,0
14,523488,-41093,35219,76312,8.8,57,0
15,453870,-33215,20659,53874,1.4,57,0
16,440531,-30907,18104,49011,0.0,57,0
17,361350,-78753,5245,83998,0.0,57,0
18,302226,-60032,303,60335,0.0,56,-1
19,245503,-57305,347,57652,0.0,56,0
20,201033,-44175,170,44345,0.0,55,-1
21,188446,-14051,785,14836,2.3,55,0
22,235681,42604,52337,9733,3.0,55,0
0,10844,8376,13147,4771,0.0,95,0
1,11395,216,5703,5487,0.0,95,0
2,69429,52386,61733,9347,1.3,95,0
3,92798,23627,35366,11739,0.0,95,0
4,72628,-19829,7822,27651,7.8,95,0
5,88129,11593,19885,8292,4.7,95,0
6,73858,-13885,8503,22388,0.0,95,0
7,56480,-18350,1727,20077,0.0,95,0
8,43997,-13476,1675,15151,0.0,95,0
9,35990,-9291,931,10222,0.0,94,-1
10,30523,-5755,254,6009,0.0,94,0
11,27138,-3532,132,3664,2.3,93,-1
12,25265,-2220,406,2626,0.0,93,0
13,22618,-1766,91,1857,0.0,93,0
14,21458,-1491,342,1833,0.0,93,0
15,21251,-299,241,540,0.0,93,0
16,21409,-444,456,900,0.0,93,0
17,22467,698,1240,542,3.0,93,0
18,22660,-107,834,941,0.0,93,0
19,22961,-96,1003,1099,0.0,93,0
20,21684,-1600,240,1840,3.7,93,0
21,22307,191,812,621,6.0,93,0
22,33314,9713,10949,1236,15.7,93,0
0,1832,1008,1400,392,0.0,70,0
1,2770,426,1106,680,0.0,70,0
2,3032,-150,652,802,0.0,70,0
3,3029,-245,360,605,3.3,70,0
4,3243,-171,375,546,0.0,70,0
5,3382,-65,261,326,0.0,70,0
6,3410,-170,311,481,0.0,70,0
7,3424,-121,229,350,0.0,69,-1
8,3477,-61,126,187,0.0,69,0
9,3484,-100,120,220,0.0,69,0
10,3612,-93,181,274,0.0,69,0
11,3656,-133,95,228,0.3,69,0
12,6118,1153,1676,523,0.0,69,0
13,5163,20,701,681,0.0,69,0
14,5294,-174,588,762,0.0,69,0
15,11969,6361,7124,763,8.1,69,0
16,11156,-863,2091,2954,1.1,69,0
17,14012,2413,4417,2004,0.0,69,0
18,8113,-5841,546,6387,0.0,69,0
19,7249,-1234,405,1639,0.0,69,0
20,7181,-352,671,1023,0.0,69,0
0,259,165,198,33,0.0,50,0
1,549,138,207,69,0.0,50,0
2,714,43,144,101,0.0,50,0
3,841,-3,154,157,0.0,50,0
4,1061,133,199,66,1.7,50,0
5,2549,1145,1388,243,0.4,50,0
6,2237,-259,235,494,0.0,50,0
7,2054,-241,72,313,0.0,50,0
8,1929,-188,58,246,0.0,50,0
9,1893,-152,102,254,0.0,50,0
10,1936,-52,79,131,0.0,50,0
11,2015,-135,118,253,0.0,50,0
12,1934,-61,32,93,1.9,50,0
13,2059,4,139,135,2.3,50,0
14,2483,337,430,93,1.4,50,0
15,2657,92,276,184,0.0,50,0
16,2933,139,351,212,0.0,50,0
17,2746,-274,127,401,0.0,50,0
18,2747,-94,88,182,0.0,50,0
19,2699,-126,102,228,0.0,50,0
0,0,0,0,0,0.0,45,0
1,26,16,19,3,0.0,45,0
2,105,31,48,17,0.0,45,0
3,249,91,150,59,0.0,45,0
4,260,-28,54,82,0.0,45,0
5,502,134,229,95,0.0,44,-1
0,0,0,0,0,0.0,45,0
1,1678,1330,1635,305,0.0,45,0
2,1687,-54,642,696,0.0,45,0
3,2101,208,755,547,0.0,45,0
0,112927,0,0,0,1.7,50,0
1,152759,13143,27762,14619,0.0,50,0
2,123510,-30409,5689,36098,1.1,50,0
3,119317,-9240,4867,14107,0.4,50,0
4,107386,-13373,3888,17261,0.0,49,-1
5,97620,-11089,1972,13061,0.0,49,0
6,88655,-9895,946,10841,0.0,48,-1
7,82022,-7020,834,7854,0.0,48,0
8,76313,-6176,829,7005,0.0,47,-1
9,73367,-3452,692,4144,0.0,47,0
10,69234,-4251,468,4719,0.0,47,0
11,66378,-3312,363,3675,1.6,47,0
12,65103,-1473,681,2154,1.9,46,-1
13,64025,-1238,674,1912,5.1,46,0
14,64337,-22,2082,2104,0.0,46,0
15,63665,-825,1116,1941,0.0,46,0
16,62749,-1103,1192,2295,0.6,46,0
17,63102,-1236,2021,3257,1.9,46,0
18,61245,-613,1128,1741,0.0,46,0
19,59725,-1859,629,2488,0.0,46,0
20,57838,-1505,329,955,0.0,46,0
21,59155,1253,1592,339,0.0,46,0
22,59296,-4,1431,1435,1.2,46,0
23,58993,-354,1183,1537,1.7,46,0
24,61245,1955,3350,1395,3.0,46,0
25,73367,11135,13745,2610,3.3,46,0
0,299163,0,0,0,0.0,40,0
1,324407,-369,17443,17812,0.0,40,0
2,328418,-3975,22204,26179,0.0,40,0
3,330781,-1824,12021,13845,0.0,40,0
4,338891,4296,27075,22779,0.0,40,0
5,346595,5914,16547,10633,0.0,40,0
6,346959,14,6628,6614,0.0,40,0
7,347216,-833,5927,6760,0.0,40,0
8,351476,2401,12543,10142,0.0,40,0
9,351694,-642,5464,6106,0.0,40,0
10,347488,-5834,5236,11070,0.0,40,0
11,347376,490,5214,4724,0.0,40,0
12,348597,801,4727,3926,0.0,40,0
13,347438,-1335,3773,5108,0.0,40,0
14,350532,1582,6444,4862,0.0,40,0
15,346965,-3614,4761,8375,0.0,40,0
16,342113,-5225,5764,10989,0.0,40,0
17,321581,-11414,5220,16634,2.3,40,0
18,321581,-11414,5220,16634,0.0,40,0
19,327059,4739,15784,11045,0.0,40,0
20,325584,-1431,4887,6318,0.0,40,0
21,324332,-1533,3470,5003,0.0,40,0
22,318461,-6081,2813,8894,0.0,40,0
23,308204,-10134,3125,13259,0.0,40,0
24,301900,-6992,1944,8936,0.0,40,0
25,285573,-15932,2525,18457,0.0,40,0
0,13584,0,0,0,0.1,55,0
1,16285,88,4678,4590,4.6,55,0
2,15578,-1685,3836,5521,10.3,55,0
3,74722,47858,62755,14897,0.7,55,0
4,61693,-10669,19782,30451,0.1,55,0
5,58564,-5357,9417,14774,1.5,55,0
6,57067,-2568,7723,10291,3.7,55,0
7,50156,-6965,4138,11103,6.6,55,0
8,44290,-6254,3912,10166,0.4,55,0
9,46143,308,5459,5151,1.8,55,0
10,46838,140,6216,6076,1.0,55,0
11,41525,-4605,2071,6676,3.0,55,0
12,39669,-2287,1999,4286,0.0,55,0
13,36666,-3041,1114,4155,0.0,55,0
14,33603,-3104,688,3792,2.3,55,0
15,33751,-123,1523,1646,1.4,54,-1
16,33298,-530,1773,2303,5.4,54,0
17,51275,13679,17945,4266,5.1,54,0
18,51275,13679,17945,4266,0.7,54,0
19,59607,11500,22238,10738,0.2,54,0
20,79227,19010,25995,6985,0.0,54,0
21,79525,189,12784,12595,5.5,54,0
22,65970,-13401,3014,16415,0.0,54,0
23,56372,-9462,3168,12630,0.0,54,0
24,53510,-3589,3569,7158,0.0,54,0
25,51512,-2227,6484,8711,0.0,54,0
0,48768,0,0,0,0.8,45,0
1,46922,-5596,2252,7848,1.5,45,0
2,26973,-19737,216,19953,0.0,44,-1
3,22237,-5502,268,5770,0.0,44,0
4,21108,-1866,842,2708,0.0,44,0
5,20106,-1264,557,1821,0.0,44,0
6,19342,-990,393,1383,0.0,44,0
7,18143,-1260,242,1502,0.0,44,0
8,17240,-1128,273,1401,0.0,43,-1
9,16123,-1170,141,1311,0.0,43,0
10,15029,-1133,121,1254,0.0,43,0
11,14916,-289,283,572,1.1,43,0
12,14927,-86,271,357,1.7,43,0
13,15155,126,492,366,1.5,43,0
14,15202,-68,556,624,2.1,43,0
15,16125,812,1234,422,0.0,43,0
16,15314,-774,352,1126,0.0,43,0
17,14518,-278,241,519,2.3,43,0
18,14518,-278,241,519,4.3,43,0
19,14489,-142,436,578,1.9,43,0
20,14410,-94,391,485,3.6,43,0
21,14351,-98,280,378,0.0,43,0
22,13917,-453,103,556,0.0,43,0
23,13609,-348,133,481,0.0,43,0
24,13318,-352,113,465,0.0,43,0
25,12679,-616,85,701,0.0,43,0
0,24892,0,0,0,0.3,55,0
1,24461,-3272,2625,5897,0.0,55,0
2,17390,-7535,1377,8912,2.0,54,-1
3,16039,-2339,1903,4242,1.1,54,0
4,12009,-4071,618,4689,0.0,53,-1
5,9956,-2167,64,2231,0.0,53,0
6,8745,-1336,41,1377,0.0,53,0
7,7963,-811,38,849,0.0,52,-1
8,7350,-618,88,706,0.0,52,0
9,7595,119,387,268,1.4,52,0
10,7866,183,555,372,0.0,52,0
11,7334,-468,113,581,0.0,52,0
12,7109,-239,50,289,0.0,52,0
13,6944,-182,18,200,0.0,52,0
14,6747,-197,33,230,0.0,52,0
15,6671,-89,15,104,0.0,52,0
16,6596,-71,70,141,0.0,52,0
17,6408,-37,41,78,0.0,52,0
18,6408,-37,41,78,0.0,52,0
19,6713,262,538,276,0.0,52,0
20,6874,149,369,220,0.0,52,0
21,6956,63,325,262,0.4,52,0
22,6832,-139,161,300,0.0,52,0
23,6817,-44,211,255,0.0,52,0
24,6922,65,237,172,0.0,52,0
25,7022,76,374,298,0.1,52,0
0,10809,0,0,0,2.0,50,0
1,10160,-1440,509,1949,2.9,50,0
2,8946,-1616,452,2068,2.4,50,0
3,9659,242,1677,1435,0.8,49,-1
4,8336,-1377,367,1744,1.1,49,0
5,7623,-835,204,1039,0.7,49,0
6,7397,-364,460,824,2.8,48,-1
7,6862,-594,192,786,0.5,48,0
8,6519,-420,340,760,0.0,48,0
9,5795,-755,57,812,0.0,48,0
10,5072,-714,23,737,0.0,48,0
11,4869,-259,72,331,0.0,47,-1
12,4829,-60,114,174,2.0,47,0
13,4801,-61,102,163,0.1,47,0
14,4340,-469,44,513,0.0,47,0
15,4191,-155,19,174,0.0,47,0
16,4030,-163,58,221,0.0,47,0
17,3961,-20,83,103,2.6,47,0
18,3961,-20,83,103,1.5,47,0
19,3980,9,139,130,3.4,47,0
20,3930,-52,79,131,1.4,47,0
21,3916,-35,57,92,0.9,47,0
22,3910,-21,61,82,0.0,47,0
23,3834,-95,25,120,0.8,47,0
24,3832,-25,53,78,0.0,47,0
25,3786,-66,40,106,0.0,47,0
0,7531,0,0,0,0.0,55,0
1,6388,-1891,166,2057,0.0,54,-1
2,4450,-2094,69,2163,0.0,54,0
3,3452,-1069,23,1092,0.0,53,-1
4,3058,-467,85,552,0.0,53,0
5,2698,-394,28,422,0.0,53,0
6,2438,-273,19,292,0.0,53,0
7,2402,-79,26,105,0.0,53,0
8,2397,-59,53,112,0.0,53,0
9,2384,-48,32,80,0.0,53,0
10,2348,-63,17,80,0.0,53,0
11,2329,-48,17,65,0.0,53,0
12,2337,-16,26,42,0.0,53,0
13,2327,-26,18,44,0.0,53,0
14,2307,-49,14,63,0.0,53,0
15,2303,-18,14,32,0.0,53,0
16,2297,-19,18,37,0.0,53,0
17,2332,10,45,35,2.6,53,0
18,2332,10,45,35,4.6,53,0
19,2421,57,127,70,0.0,53,0
20,2396,-41,29,70,0.0,53,0
21,2363,-47,20,67,0.0,52,-1
22,2356,-23,24,47,0.0,52,0
23,2342,-32,28,60,0.0,52,0
24,2358,-13,28,41,0.0,52,0
25,2347,-30,21,51,0.0,52,0
0,8154,0,0,0,0.0,55,0
1,6107,-2566,296,2862,0.4,54,-1
2,4945,-1394,273,1667,0.8,53,-1
3,4638,-510,440,950,0.0,53,0
4,4064,-676,199,875,0.3,52,-1
5,3802,-363,171,534,0.0,52,0
6,3650,-221,127,348,3.5,52,0
7,3504,-211,105,316,0.5,51,-1
8,3494,-91,189,280,0.0,51,0
9,3460,-97,122,219,0.5,51,0
10,3385,-110,126,236,9.1,51,0
11,3499,52,245,193,8.4,51,0
12,3964,383,580,197,2.5,51,0
13,3979,-8,291,299,1.3,51,0
14,3922,-105,213,318,1.3,51,0
15,3946,-5,151,156,0.3,51,0
16,3944,-43,185,228,5.8,51,0
17,4013,49,213,164,0.0,51,0
18,4013,49,213,164,0.0,51,0
19,3802,-203,94,297,0.2,51,0
20,3683,-137,46,183,0.8,51,0
21,3621,-79,49,128,11.3,51,0
22,3749,90,198,108,1.9,51,0
23,3642,-121,68,189,0.1,51,0
24,3656,-8,119,127,0.2,51,0
25,3657,-37,173,210,1.0,51,0
0,9197,0,0,0,1.4,45,0
1,9826,-781,658,1439,2.3,45,0
2,9129,-1219,440,1659,8.6,45,0
3,13349,2574,4046,1472,1.2,45,0
4,16830,2176,4721,2545,0.0,45,0
5,14503,-1680,612,2292,0.0,45,0
6,13229,-1509,269,1778,0.0,45,0
7,11967,-1342,120,1462,2.0,45,0
8,11351,-754,174,928,2.6,44,-1
9,12124,428,999,571,5.7,44,0
10,13969,1231,2053,822,3.7,44,0
11,12539,-833,441,1274,0.0,44,0
12,11339,-1231,149,1380,0.0,44,0
13,9898,-1464,12,1476,0.0,44,0
14,8796,-1115,17,1132,0.0,44,0
15,8319,-508,13,521,0.0,44,0
16,7789,-542,23,565,0.4,44,0
17,7724,-3,242,245,6.9,44,0
18,7724,-3,242,245,1.6,44,0
19,8047,274,634,360,2.4,44,0
20,8224,140,456,316,6.4,44,0
21,9949,1563,2031,468,3.3,44,0
22,9127,-805,271,1076,2.5,44,0
23,8933,-260,389,649,2.3,44,0
24,9443,418,881,463,1.7,44,0
25,14791,4783,6176,1393,8.2,44,0
0,3307,0,0,0,0.2,50,0
1,3391,-396,112,508,1.8,50,0
2,3222,-445,142,587,2.4,50,0
3,3323,-108,304,412,1.7,50,0
4,3135,-287,211,498,0.2,49,-1
5,2961,-232,76,308,0.0,49,0
6,2808,-204,47,251,1.5,49,0
7,2637,-211,27,238,0.0,48,-1
8,2494,-202,40,242,2.0,48,0
9,2576,32,167,135,1.5,48,0
10,2566,-48,174,222,1.1,48,0
11,2546,-39,103,142,2.5,48,0
12,2611,40,169,129,0.5,48,0
13,2558,-75,84,159,1.8,48,0
14,2593,1,128,127,3.6,48,0
15,2673,63,151,88,0.0,48,0
16,2636,-54,83,137,2.0,48,0
17,2804,141,274,133,1.8,48,0
18,2804,141,274,133,1.1,48,0
19,2695,-53,139,192,0.6,48,0
20,2644,-56,120,176,0.0,47,-1
21,2558,-108,43,151,0.0,47,0
22,2470,-106,24,130,0.4,47,0
23,2420,-66,34,100,0.0,47,0
24,2400,-38,32,70,0.0,47,0
25,2418,-5,88,93,0.0,46,-1
0,43295,0,0,0,3.1,45,0
1,52526,1313,8778,7465,1.4,45,0
2,48344,-5507,3358,8865,4.7,45,0
3,50768,285,5033,4748,3.9,45,0
4,55362,2299,8210,5911,2.9,45,0
5,62391,5820,9979,4159,2.0,45,0
6,76088,10158,13478,3320,1.5,45,0
7,74000,-1423,5229,6652,3.0,45,0
8,74924,145,5446,5301,4.3,45,0
9,97761,15649,19188,3539,4.0,45,0
10,147390,40177,46848,6671,1.4,45,0
11,134553,-1546,11623,13169,2.6,45,0
12,129400,-5619,6131,11750,5.2,45,0
13,142726,11607,16839,5232,5.2,45,0
14,153983,9530,18489,8959,0.9,45,0
15,185527,30310,37663,7353,1.0,45,0
16,196240,10245,26113,15868,6.4,45,0
17,243234,37678,52659,14981,0.0,45,0
18,243234,37678,52659,14981,3.0,45,0
19,221510,-11121,9955,21076,1.5,45,0
20,219940,-2192,8444,10636,3.5,45,0
21,218107,-2572,7235,9807,2.2,45,0
22,196286,-22029,1844,23873,3.1,45,0
23,175775,-19896,2039,21935,3.1,45,0
24,176444,-1090,7027,8117,1.1,45,0
25,190245,12578,23548,10970,4.2,45,0
0,4560,0,0,0,0.0,45,0
1,4540,-696,196,892,0.0,45,0
2,5451,-143,599,742,1.8,45,0
3,6024,-6,563,569,1.8,45,0
4,6693,98,685,587,6.7,45,0
5,7750,605,1086,481,3.9,45,0
6,10107,1718,2403,685,3.2,45,0
7,9757,-383,974,1357,2.7,45,0
8,10141,-69,804,873,4.9,45,0
9,13732,2593,3651,1058,1.3,45,0
10,10701,-2440,918,3358,0.0,45,0
11,8792,-1934,79,2013,0.0,45,0
12,8024,-826,49,875,0.0,45,0
13,7392,-671,15,686,0.0,45,0
14,6799,-589,23,612,0.0,44,-1
15,6585,-228,17,245,0.0,44,0
16,6342,-250,45,295,0.0,44,0
17,5954,-102,24,126,0.0,44,0
18,5954,-102,24,126,0.0,44,0
19,5845,-132,50,182,0.0,44,0
20,5973,77,164,87,0.0,44,0
21,6023,15,134,119,3.2,44,0
22,6072,-7,107,114,3.9,44,0
23,6179,32,165,133,3.3,44,0
24,6461,191,313,122,0.6,44,0
25,7825,1167,1510,343,0.0,44,0
0,21428,0,0,0,0.1,50,0
1,19279,-4020,1124,5144,1.1,50,0
2,16116,-3877,637,4514,2.1,49,-1
3,15371,-1386,736,2122,0.9,49,0
4,14745,-1174,740,1914,0.0,49,0
5,13702,-1164,279,1443,1.7,49,0
6,13512,-459,370,829,2.2,48,-1
7,12898,-699,219,918,3.6,48,0
8,12695,-430,358,788,1.6,48,0
9,13399,314,842,528,1.3,48,0
10,15332,1472,2350,878,3.2,48,0
11,13996,-1008,442,1450,5.3,48,0
12,13540,-582,353,935,2.6,48,0
13,14367,579,1065,486,1.6,48,0
14,13979,-495,453,948,7.2,48,0
15,18273,3898,4421,523,1.9,48,0
16,18526,188,2186,1998,1.6,48,0
17,18226,546,1788,1242,7.9,48,0
18,18226,546,1788,1242,0.9,48,0
19,20212,1845,3831,1986,3.9,48,0
20,22566,2168,3898,1730,4.7,48,0
21,23531,684,3116,2432,2.2,48,0
22,20614,-2987,525,3512,2.7,48,0
23,19272,-1439,654,2093,2.0,48,0
24,21106,1410,2748,1338,0.0,48,0
25,16421,-4526,375,4901,0.0,48,0
0,2162,0,0,0,2.5,50,0
1,2409,-263,155,418,0.0,50,0
2,2283,-346,99,445,0.0,50,0
3,2171,-226,84,310,1.8,49,-1
4,2071,-178,50,228,0.0,49,0
5,1989,-135,30,165,2.0,49,0
6,1967,-77,31,108,0.0,49,0
7,1973,-47,59,106,0.1,48,-1
8,1967,-63,56,119,0.0,48,0
9,1941,-56,39,95,0.0,48,0
10,1890,-76,23,99,0.0,48,0
11,1845,-67,11,78,0.0,48,0
12,1833,-23,24,47,0.0,48,0
13,1824,-34,19,53,0.0,47,-1
14,1857,-7,41,48,0.0,47,0
15,1870,0,28,28,0.0,47,0
16,1864,-18,30,48,0.0,47,0
17,1834,-17,23,40,0.0,47,0
18,1834,-17,23,40,0.0,47,0
19,1860,-5,58,63,0.0,47,0
20,1839,-36,14,50,0.0,47,0
21,1833,-18,20,38,0.0,47,0
22,1807,-40,7,47,0.0,47,0
23,1825,-3,46,49,0.0,47,0
24,1902,48,108,60,0.0,47,0
25,1853,-70,46,116,0.0,47,0
0,5791,0,0,0,3.0,45,0
1,8033,146,1199,1053,1.8,45,0
2,8001,-644,790,1434,5.3,45,0
3,8633,43,992,949,0.0,45,0
4,8560,-464,573,1037,5.7,45,0
5,9999,1003,1727,724,2.9,45,0
6,11141,824,1816,992,4.6,45,0
7,10085,-964,333,1297,7.9,45,0
8,9953,-361,590,951,0.9,45,0
9,15402,3957,5256,1299,5.0,45,0
10,18070,1923,4847,2924,4.6,45,0
11,15020,-1639,1184,2823,7.3,45,0
12,18699,3002,4557,1555,0.9,45,0
13,22930,4005,5831,1826,1.1,45,0
14,22195,-789,2178,2967,4.1,45,0
15,25832,3303,4855,1552,1.9,45,0
16,25211,-618,3089,3707,1.3,45,0
17,25648,1832,4651,2819,0.0,45,0
18,25648,1832,4651,2819,1.5,45,0
19,21568,-2797,933,3730,2.0,45,0
20,21957,182,2646,2464,0.5,45,0
21,21804,-316,2149,2465,0.0,45,0
22,18189,-3639,158,3797,0.0,45,0
23,16158,-2026,158,2184,2.9,45,0
24,15841,-506,568,1074,0.8,45,0
25,19396,3061,4619,1558,3.0,45,0
0,19684,0,0,0,1.0,45,0
1,19736,-2086,695,2781,2.8,45,0
2,17624,-2823,478,3301,2.0,45,0
3,16883,-1262,444,1706,4.9,44,-1
4,16780,-583,1312,1895,0.0,44,0
5,15655,-1167,338,1505,0.0,44,0
6,14808,-1027,218,1245,0.0,44,0
7,13894,-976,143,1119,2.8,43,-1
8,13834,-297,568,865,0.0,43,0
9,13608,-347,263,610,0.0,43,0
10,13049,-568,200,768,1.5,43,0
11,12819,-319,206,525,2.9,43,0
12,12703,-173,202,375,3.6,43,0
13,13032,239,572,333,2.0,43,0
14,13198,85,683,598,1.9,43,0
15,14392,1083,1485,402,2.2,43,0
16,14515,64,870,806,2.9,43,0
17,14567,235,908,673,1.8,43,0
18,14567,235,908,673,4.0,43,0
19,13945,-408,414,822,1.5,43,0
20,13676,-325,325,650,0.6,43,0
21,13325,-380,134,514,1.9,43,0
22,12882,-482,88,570,0.0,43,0
23,12455,-461,129,590,0.0,42,-1
24,12354,-182,170,352,1.2,42,0
25,12360,-69,381,450,1.8,42,0
0,9364,0,0,0,0.0,60,0
1,8396,-2110,172,2282,0.0,60,0
2,7227,-1605,149,1754,0.0,59,-1
3,6708,-863,159,1022,0.0,59,0
4,6317,-688,144,832,0.0,58,-1
5,6138,-316,106,422,0.0,58,0
6,5900,-343,79,422,0.0,58,0
7,5767,-244,91,335,0.0,58,0
8,5738,-207,111,318,0.0,57,-1
9,5714,-103,89,192,0.0,57,0
10,5597,-192,65,257,0.0,57,0
11,5533,-125,76,201,0.0,57,0
12,5547,-42,83,125,0.1,57,0
13,5506,-86,45,131,0.0,57,0
14,5543,-81,93,174,0.0,57,0
15,5496,-77,31,108,0.0,57,0
16,5531,-60,89,137,0.0,57,0
17,6389,606,842,236,4.1,57,0
18,6389,606,842,236,0.0,57,0
19,6281,-46,405,451,1.9,57,0
20,6040,-261,119,380,1.0,57,0
21,6081,-3,223,226,2.8,56,-1
22,5928,-192,69,261,4.0,56,0
23,5860,-132,80,212,3.4,56,0
24,5841,-79,160,239,0.0,56,0
25,5596,-248,27,275,0.0,56,0
0,37744,0,0,0,2.7,55,0
1,34399,-4989,1716,6705,8.7,55,0
2,45313,8010,16876,8866,4.4,55,0
3,54990,8349,15433,7084,1.8,55,0
4,48038,-6729,3995,10724,4.1,55,0
5,42658,-5674,1260,6934,2.2,55,0
6,39147,-3967,1297,5264,3.5,55,0
7,32568,-6551,323,6874,0.2,55,0
8,27607,-5035,484,5519,2.9,54,-1
9,26831,-1291,1103,2394,0.0,54,0
10,23367,-3278,338,3616,1.1,53,-1
11,21743,-1890,191,2081,0.0,53,0
12,20425,-1378,309,1687,2.3,52,-1
13,19605,-878,242,1120,0.7,52,0
14,18579,-1037,156,1193,1.6,52,0
15,18253,-398,244,642,2.8,52,0
16,17603,-677,191,868,0.2,51,-1
17,16751,-82,546,628,0.0,51,0
18,16751,-82,546,628,0.0,51,0
19,15795,-884,111,995,0.0,51,0
20,15212,-620,75,695,0.0,51,0
21,14815,-421,62,483,0.0,51,0
22,14383,-438,25,463,0.0,50,-1
23,14031,-377,87,464,0.0,50,0
24,13720,-334,144,478,0.0,50,0
25,13571,-196,121,317,0.0,50,0
0,182852,0,0,0,4.9,60,0
1,150712,-36160,4945,41105,7.8,60,0
2,170094,8997,42449,33452,5.7,60,0
3,264047,82914,111024,28110,3.6,60,0
4,240207,-23505,30711,54216,10.9,60,0
5,207851,-32315,6770,39085,2.9,60,0
6,189643,-20615,7807,28422,1.2,60,0
7,139822,-48937,1156,50093,0.0,59,-1
8,103075,-36751,675,37426,3.8,58,-1
9,101361,-4835,5425,10260,16.8,58,0
10,92595,-8799,3549,12348,4.6,57,-1
11,69403,-22974,228,23202,0.0,57,0
12,61551,-8225,41,8266,0.0,56,-1
13,56364,-5368,28,5396,0.0,56,0
14,53809,-2620,282,2902,3.7,56,0
15,53887,-155,1108,1263,0.4,56,0
16,52215,-1686,419,2105,4.8,56,0
17,50842,275,1629,1354,13.9,56,0
18,50842,275,1629,1354,5.6,56,0
19,70363,17099,25197,8098,2.5,56,0
20,89542,17906,25076,7170,6.2,56,0
21,193613,99376,105745,6369,4.4,56,0
22,149207,-44032,10875,54907,1.4,56,0
23,121014,-29117,8827,37944,4.4,55,-1
24,114935,-8597,10761,19358,9.8,55,0
25,149896,32018,48030,16012,3.2,54,-1
0,2348,1337,1991,654,0.0,45,0
1,4075,931,1790,859,0.0,45,0
2,5006,232,967,735,0.0,45,0
3,5709,100,989,889,7.9,45,0
4,8585,2243,2870,627,1.4,45,0
5,11861,2831,3572,741,3.6,45,0
6,11165,-695,819,1514,0.0,45,0
7,9719,-1506,270,1776,1.0,45,0
8,10874,598,1161,563,0.0,45,0
9,12075,853,1533,680,1.2,45,0
10,11126,-748,486,1234,1.1,45,0
11,10552,-678,434,1112,0.0,45,0
12,10179,-506,391,897,0.3,45,0
13,9556,-819,360,1179,0.0,45,0
14,9283,-390,225,615,1.5,45,0
15,8927,-456,236,692,0.8,45,0
16,8290,-255,210,465,0.0,45,0
17,8290,-255,210,465,0.0,45,0
18,7917,-486,177,663,0.0,45,0
19,7655,-312,91,403,0.0,45,0
20,7524,-189,123,312,0.0,44,-1
21,7337,-245,100,345,0.0,44,0
22,7197,-195,146,341,0.0,44,0
23,7166,-109,128,237,0.0,44,0
24,7122,-118,145,263,0.3,44,0
0,329,211,287,76,0.0,55,0
1,646,157,268,111,0.0,55,0
2,793,-43,143,186,3.9,55,0
3,916,8,116,108,2.8,55,0
4,1103,93,181,88,3.7,55,0
5,1102,-75,88,163,3.0,55,0
6,1349,81,238,157,7.4,55,0
7,1871,389,557,168,7.5,55,0
8,4015,1694,2137,443,7.0,55,0
9,8649,4336,5285,949,4.8,55,0
10,10195,1455,3020,1565,0.4,55,0
11,10434,100,2044,1944,1.4,55,0
12,9783,-900,1059,1959,1.9,55,0
13,10122,145,1131,986,1.3,55,0
14,9071,-1091,552,1643,3.2,55,0
15,5352,-1227,51,1278,0.0,55,0
16,5352,-1227,51,1278,4.9,55,0
17,5151,-373,296,669,0.0,55,0
18,4848,-337,239,576,1.8,55,0
19,4726,-160,290,450,0.3,55,0
20,4352,-429,52,481,0.7,55,0
21,4159,-261,75,336,4.2,55,0
22,4720,457,740,283,3.0,55,0
23,4885,56,728,672,6.6,55,0
0,0,0,0,0,2.6,60,0
1,864,634,746,112,7.4,60,0
2,4228,2776,3205,429,2.7,60,0
3,3563,-627,783,1410,1.7,60,0
4,3412,-350,800,1150,2.4,59,-1
5,4450,753,1619,866,7.4,59,0
6,4516,32,1197,1165,3.6,59,0
7,3732,-714,457,1171,1.3,59,0
8,3703,-175,648,823,2.3,59,0
9,3518,-247,418,665,1.4,59,0
10,3142,-415,269,684,3.2,58,-1
11,3697,468,795,327,0.5,58,0
12,3577,-155,511,666,0.0,58,0
13,2455,-425,65,490,0.0,58,0
14,2455,-425,65,490,0.0,58,0
15,2267,-213,150,363,0.8,58,0
16,2924,598,837,239,2.8,58,0
17,3189,219,687,468,0.3,58,0
18,2753,-459,155,614,0.6,58,0
19,2740,-77,276,353,0.0,57,-1
20,2748,-30,240,270,0.0,57,0
21,2861,76,397,321,0.0,57,0
0,0,0,0,0,0.0,40,0
1,1905,1143,1442,299,0.0,40,0
2,2300,107,828,721,0.0,40,0
3,2833,106,739,633,0.0,40,0
4,3124,177,684,507,0.0,40,0
5,3810,469,834,365,0.1,40,0
6,3796,-179,414,593,0.0,40,0
7,4462,253,686,433,0.0,40,0
8,4824,201,452,251,2.8,40,0
9,5029,52,512,460,0.0,40,0
10,5514,112,449,337,0.0,40,0
11,5514,112,449,337,0.0,40,0
12,5356,-100,417,517,0.0,40,0
13,5255,-191,183,374,0.0,40,0
14,5181,-157,186,343,0.0,40,0
15,5153,-133,180,313,3.1,40,0
16,5216,-106,295,401,0.7,40,0
17,5023,-223,156,379,0.0,40,0
18,5133,-38,329,367,0.0,40,0
0,0,0,0,0,0.0,45,0
1,4283,1442,2234,792,0.0,45,0
2,4283,1442,2234,792,0.0,45,0
3,3847,313,1465,1152,0.0,45,0
4,4456,468,1136,668,0.0,45,0
5,4811,214,1070,856,0.0,45,0
6,4901,-84,830,914,0.0,45,0
7,5156,-24,1043,1067,0.0,45,0
8,6084,707,1499,792,0.0,45,0
9,7242,822,2082,1260,0.0,45,0
0,0,0,0,0,0.0,40,0
1,0,0,0,0,0.0,40,0
2,976,809,953,144,0.0,40,0
3,1483,431,621,190,0.0,40,0
4,1922,376,539,163,0.0,40,0
5,2059,93,369,276,0.0,40,0
6,2200,66,303,237,0.0,40,0
7,2444,187,349,162,0.0,40,0
8,2555,27,365,338,0.0,40,0
0,0,0,0,0,4.6,60,0
1,9155,8464,9144,680,3.7,60,0
2,11336,1675,4182,2507,3.1,60,0
3,12272,744,4055,3311,9.4,60,0
4,33054,19860,23057,3197,3.4,60,0
5,62672,27540,35898,8358,0.8,60,0
0,66,63,73,10,0.0,45,0
1,131,35,69,34,0.8,45,0
2,196,40,103,63,0.8,45,0
3,352,121,196,75,2.4,45,0
4,568,152,336,184,0.8,45,0
0,15558,-392,1594,1986,0.0,60,0
1,14109,-2884,831,3715,0.0,60,0
2,13422,-1772,604,2376,0.0,59,-1
3,13022,-1246,492,1738,0.0,59,0
4,12175,-1089,221,1310,0.0,59,0
5,10962,-1283,49,1332,0.0,59,0
6,10389,-645,69,714,0.0,59,0
7,10075,-410,93,503,0.0,59,0
8,9893,-220,52,272,0.0,59,0
9,10187,78,274,196,0.0,59,0
10,10372,-11,218,229,0.0,59,0
11,10454,-26,172,198,0.0,59,0
12,10539,-37,140,177,0.0,59,0
13,10738,-36,267,303,0.0,59,0
14,10806,-46,120,166,0.0,59,0
15,10884,-42,160,202,0.0,59,0
16,11235,12,345,333,0.0,59,0
17,11213,-18,139,157,0.0,59,0
18,11213,-18,139,157,0.0,59,0
19,11363,-70,232,302,0.0,59,0
20,12872,892,610,138,0.0,59,0
21,14855,1842,2092,250,17.4,59,0
22,258242,236958,240850,3892,2.5,60,1
23,227721,-26806,30913,57719,7.4,60,0
24,201296,-30702,17988,48690,6.8,60,0
0,143896,0,0,0,1.7,50,0
1,115916,-29130,1800,30930,0.0,50,0
2,81800,-34931,587,35518,0.3,49,-1
3,72826,-10582,1143,11725,0.0,49,0
4,60073,-13096,801,13897,0.0,48,-1
5,53146,-7471,876,8347,0.0,48,0
6,48222,-5278,454,5732,0.0,48,0
7,43720,-4633,638,5271,0.0,47,-1
8,36540,-6842,118,6960,0.0,47,0
9,35974,-1189,555,1744,0.0,47,0
10,34360,-1611,552,2163,0.0,47,0
11,33487,-1071,499,1570,0.1,47,0
12,32610,-935,307,1242,0.0,47,0
13,32003,-682,354,1036,1.7,46,-1
14,32358,104,1407,1303,2.1,46,0
15,31942,-420,579,999,0.0,46,0
16,31483,-528,558,1086,0.0,46,0
17,30242,-416,522,938,0.0,46,0
18,30242,-416,522,938,0.0,46,0
19,29514,-827,319,1146,0.0,46,0
20,28719,-837,126,963,0.2,46,0
21,28282,-482,170,652,0.0,46,0
22,27810,-521,168,689,0.4,46,0
23,27402,-464,244,708,0.4,46,0
24,27170,-305,161,466,0.0,46,0
0,498030,0,0,0,0.0,40,0
1,518484,-9726,13989,23715,0.0,40,0
2,518377,-11062,19148,30210,0.0,40,0
3,518235,-6454,12034,18488,0.0,40,0
4,529570,4868,32616,27748,0.0,40,0
5,544952,11269,26575,15306,0.0,40,0
6,548870,2788,12963,10175,0.0,40,0
7,550181,-389,11129,11518,0.0,40,0
8,557295,3319,16761,13442,0.0,40,0
9,559479,410,9112,8702,0.0,40,0
10,559526,-3422,10820,14242,0.0,40,0
11,562307,3496,11203,7707,0.0,40,0
12,563541,422,7681,7259,0.0,40,0
13,563770,-166,6981,7147,0.0,40,0
14,573874,6470,13969,7499,0.0,40,0
15,573339,-545,8178,8723,0.0,40,0
16,569206,-4856,10064,14920,0.0,40,0
17,526425,-23356,4965,28321,0.0,40,0
18,526425,-23356,4965,28321,0.0,40,0
19,518673,-13573,3480,17053,0.0,40,0
20,510407,-8598,1866,10464,0.0,40,0
21,504245,-6509,1559,8068,0.0,40,0
22,491034,-13201,951,14152,0.0,40,0
23,476346,-13934,889,14823,0.0,40,0
24,469454,-8237,826,9063,0.0,40,0
0,16045,0,0,0,0.0,45,0
1,17208,-1090,308,1398,0.0,45,0
2,16798,-1213,209,1422,0.0,45,0
3,16547,-724,167,891,0.0,45,0
4,16261,-819,249,1068,0.0,45,0
5,16007,-500,168,668,0.0,45,0
6,15862,-328,191,519,0.0,44,-1
7,15712,-268,153,421,0.0,44,0
8,15640,-272,194,466,0.0,44,0
9,15516,-171,142,313,0.0,44,0
10,15273,-294,151,445,0.0,44,0
11,15143,-240,102,342,0.0,44,0
12,15022,-177,55,232,0.0,44,0
13,14938,-132,61,193,0.0,44,0
14,14843,-191,109,300,0.0,44,0
15,14727,-149,52,201,0.0,44,0
16,14570,-219,61,280,1.4,44,0
17,30769,9392,13139,3747,0.0,44,0
18,30769,9392,13139,3747,0.0,44,0
19,22663,-4363,278,4641,0.0,44,0
20,21058,-1644,44,1688,0.0,44,0
21,19894,-1204,35,1239,0.0,44,0
22,18343,-1569,29,1598,0.0,43,-1
23,17276,-1011,81,1092,0.0,43,0
24,16903,-471,65,536,0.0,43,0
0,102540,0,0,0,0.5,50,0
1,99714,-13627,2101,15728,0.8,50,0
2,94599,-9710,2515,12225,1.5,50,0
3,94583,-3556,2708,6264,0.0,50,0
4,105586,5546,12838,7292,1.9,50,0
5,107500,-648,6510,7158,4.1,50,0
6,113829,2359,6632,4273,3.1,50,0
7,136420,15852,21012,5160,4.3,50,0
8,229273,65432,75725,10293,3.5,50,0
9,276973,51729,62088,10359,3.0,50,0
10,333463,49857,66234,16377,1.8,51,1
11,360142,24102,38813,14711,4.4,51,0
12,372824,10056,22160,12104,1.1,51,0
13,364719,-8440,11649,20089,3.1,51,0
14,367827,480,19559,19079,1.4,51,0
15,362869,-5026,17755,22781,2.3,51,0
16,373334,8505,27866,19361,0.0,51,0
17,329251,4895,47389,42494,1.0,51,0
18,329251,4895,47389,42494,1.1,51,0
19,318086,-3723,14949,18672,1.0,51,0
20,302430,-15761,3473,19234,1.4,51,0
21,297092,-6172,4612,10784,0.6,51,0
22,311177,11944,23321,11377,2.2,51,0
23,301717,-10193,10524,20717,3.9,51,0
24,293990,-9052,5819,14871,1.8,51,0
0,25125,0,0,0,3.7,50,0
1,23987,-4340,667,5007,4.4,50,0
2,23227,-2377,889,3266,2.3,50,0
3,24233,-418,1519,1937,1.7,49,-1
4,27552,1215,3187,1972,2.5,49,0
5,28770,394,2687,2293,1.1,49,0
6,29960,388,1963,1575,1.1,49,0
7,32703,1654,3501,1847,1.1,49,0
8,27985,-4027,386,4413,1.4,49,0
9,30549,1518,2457,939,8.7,49,0
10,60120,23509,26048,2539,2.2,49,0
11,66287,7017,12375,5358,10.8,49,0
12,129193,56551,59703,3152,1.4,49,0
13,165415,35732,43737,8005,1.7,50,1
14,195124,26148,37888,11740,1.2,50,0
15,191819,-2299,11068,13367,1.4,50,0
16,195006,2057,15851,13794,2.7,50,0
17,293737,72281,88790,16509,6.6,50,0
18,293737,72281,88790,16509,1.5,50,0
19,259204,-11767,15970,27737,1.0,50,0
20,230311,-28911,3854,32765,1.0,50,0
21,222303,-8951,5221,14172,1.1,50,0
22,221480,-2162,11802,13964,0.8,50,0
23,163416,-55235,5220,60455,0.0,50,0
24,120664,-45639,128,45767,0.0,49,-1
0,70232,0,0,0,2.2,50,0
1,62831,-12662,1523,14185,6.2,50,0
2,58281,-7282,2292,9574,8.8,49,-1
3,61303,77,5241,5164,10.5,49,0
4,255018,148325,175436,27111,6.8,49,0
5,409738,144609,167136,22527,2.4,50,1
6,495472,79483,102254,22771,2.4,50,0
7,591798,86430,129763,43333,9.8,51,1
8,701664,91007,124019,33012,4.0,51,0
9,799406,105082,125744,20662,1.9,52,1
10,826057,33441,72092,38651,5.2,52,0
11,828738,-4686,39220,43906,6.3,52,0
12,886573,50874,66585,15711,1.1,52,0
13,891542,5430,37935,32505,3.9,52,0
14,951670,54438,95615,41177,4.4,53,1
15,967983,15432,49964,34532,2.0,53,0
16,997919,26545,67591,41046,2.6,53,0
17,1432683,286229,317337,31108,1.8,54,1
18,1432683,286229,317337,31108,6.8,54,0
19,1518027,144620,196418,51798,4.7,54,0
20,1583952,63371,117855,54484,1.7,55,1
21,1737759,146283,165208,18925,5.1,56,1
22,1924880,176569,203603,27034,5.3,57,1
23,2066573,129954,170054,40100,6.1,58,1
24,2132355,58278,120087,61809,4.3,58,0
0,14140,0,0,0,3.0,60,0
1,11308,-4121,512,4633,0.7,59,-1
2,9759,-2231,917,3148,0.0,59,0
3,8650,-1504,527,2031,0.0,58,-1
4,7565,-1438,268,1706,0.1,57,-1
5,7267,-509,274,783,1.2,57,0
6,7017,-433,235,668,0.1,57,0
7,6960,-217,337,554,0.0,57,0
8,6250,-773,128,901,0.0,56,-1
9,5903,-379,16,395,0.0,56,0
10,5596,-327,45,372,0.0,56,0
11,5622,-65,108,173,0.0,56,0
12,5618,-45,93,138,0.5,56,0
13,5598,-74,70,144,0.0,56,0
14,5659,-46,125,171,3.6,55,-1
15,5712,13,98,85,2.3,55,0
16,5754,-24,118,142,1.3,55,0
17,5852,51,172,121,4.9,55,0
18,5852,51,172,121,5.3,55,0
19,5866,-50,136,186,0.0,55,0
20,5781,-113,50,163,0.2,55,0
21,5787,-42,47,89,0.0,55,0
22,5790,-49,65,114,0.0,55,0
23,5674,-160,37,197,0.0,55,0
24,5552,-129,9,138,0.0,55,0
0,642088,0,0,0,8.0,65,0
1,495278,-172615,17622,190237,10.2,64,-1
2,437401,-78588,27950,106538,7.6,64,0
3,362949,-81092,13628,94720,14.0,63,-1
4,364653,-11522,46069,57591,6.9,63,0
5,289545,-73133,7458,80591,5.4,63,0
6,246455,-47243,12059,59302,0.0,63,0
7,188161,-58418,1827,60245,0.0,62,-1
8,159300,-29877,3401,33278,0.0,62,0
9,153653,-7098,2095,9193,0.3,62,0
10,153858,-907,14468,15375,0.0,62,0
11,137628,-15748,446,16194,0.0,62,0
12,132865,-5147,387,5534,0.0,62,0
13,129348,-3648,476,4124,0.0,62,0
14,126298,-3107,1643,4750,0.0,62,0
15,125276,-1197,1550,2747,0.2,62,0
16,145386,19377,23931,4554,4.1,62,0
17,729174,496242,513920,17678,10.1,63,1
18,729174,496242,513920,17678,9.0,63,0
19,1112259,432078,469558,37480,11.0,64,1
20,1312879,200892,249213,48321,4.9,65,1
21,1538818,220300,257668,37368,12.6,66,1
22,1830242,280952,301977,21025,0.1,67,1
23,1518522,-289225,55611,344836,0.0,67,0
24,1056700,-480525,8674,489199,11.3,66,-1
0,41931,0,0,0,8.4,45,0
1,35945,-7919,1144,9063,5.3,45,0
2,38706,-191,5768,5959,4.0,45,0
3,27570,-10641,422,11063,0.0,45,0
4,23268,-4844,724,5568,0.0,44,-1
5,22446,-1282,800,2082,0.0,44,0
6,21249,-1395,341,1736,0.0,44,0
7,19984,-1366,294,1660,0.0,44,0
8,18981,-1147,405,1552,0.0,43,-1
9,18340,-784,314,1098,0.0,43,0
10,17337,-1013,217,1230,0.0,43,0
11,16186,-1214,81,1295,0.0,43,0
12,16636,247,821,574,0.0,42,-1
13,16463,-163,429,592,0.0,42,0
14,17146,451,1313,862,0.0,42,0
15,16957,-173,473,646,9.1,42,0
16,19044,1881,2871,990,0.0,42,0
17,17669,22,1266,1244,0.0,42,0
18,17669,22,1266,1244,0.0,42,0
19,17090,-411,800,1211,0.3,42,0
20,16753,-378,360,738,0.1,42,0
21,16478,-327,201,528,5.4,42,0
22,16679,93,595,502,0.4,42,0
23,16814,12,702,690,5.0,42,0
24,17681,718,1224,506,0.0,42,0
0,2974,0,0,0,0.0,65,0
1,3554,-357,266,623,0.0,65,0
2,3676,-471,330,801,0.0,65,0
3,3763,-303,291,594,0.0,64,-1
4,3899,-262,338,600,4.2,64,0
5,6928,2026,2668,642,0.0,64,0
6,7476,152,1419,1267,1.3,64,0
7,7762,-40,1225,1265,0.8,64,0
8,7665,-405,752,1157,0.4,64,0
9,7523,-288,448,736,0.0,64,0
10,7294,-381,351,732,1.2,64,0
11,7399,-85,506,591,0.0,64,0
12,7389,-109,487,596,3.2,64,0
13,7396,-69,358,427,0.0,64,0
14,6801,-676,225,901,5.6,64,0
15,6981,105,407,302,0.4,64,0
16,7220,143,471,328,0.4,64,0
17,7919,383,736,353,0.4,64,0
18,7919,383,736,353,5.7,64,0
19,7821,-126,483,609,0.0,64,0
20,7511,-365,136,501,0.0,64,0
21,7453,-151,162,313,0.0,64,0
22,7537,-33,345,378,0.0,64,0
23,7498,-167,278,445,4.5,64,0
24,7554,-37,244,281,0.0,64,0
0,15272,0,0,0,0.0,45,0
1,15134,-2578,397,2975,3.1,45,0
2,16174,-372,1760,2132,10.1,45,0
3,39555,16834,21409,4575,1.9,45,0
4,79278,33193,50716,17523,5.3,45,0
5,89190,9361,18911,9550,1.6,45,0
6,95686,5264,11339,6075,2.9,45,0
7,127192,26603,33675,7072,4.5,45,0
8,139842,12187,21505,9318,3.2,45,0
9,171243,28587,34762,6175,1.6,45,0
10,172557,3722,14801,11079,3.3,45,0
11,160339,-13383,10729,24112,0.0,45,0
12,124519,-35624,277,35901,0.0,45,0
13,90869,-34479,81,34560,0.0,45,0
14,66727,-24095,71,24166,0.0,45,0
15,59505,-7811,51,7862,0.0,44,-1
16,51732,-7904,74,7978,0.0,44,0
17,41525,-4040,33,4073,0.0,44,0
18,41525,-4040,33,4073,0.0,44,0
19,38916,-3130,62,3192,0.0,44,0
20,37222,-1761,60,1821,0.0,43,-1
21,35920,-1317,18,1335,0.0,43,0
22,34584,-1343,34,1377,0.0,43,0
23,33221,-1331,30,1361,0.0,43,0
24,32553,-732,48,780,0.0,43,0
0,11269,0,0,0,0.0,45,0
1,10766,-1753,316,2069,0.0,45,0
2,9947,-1411,343,1754,2.1,44,-1
3,12335,1417,2697,1280,2.4,44,0
4,28050,12609,18424,5815,6.6,44,0
5,59540,27818,35380,7562,1.8,44,0
6,72502,12590,18165,5575,1.9,44,0
7,94399,19176,25550,6374,2.8,44,0
8,109087,13709,21193,7484,1.0,44,0
9,124540,14622,19306,4684,1.8,44,0
10,135996,11414,19032,7618,3.9,44,0
11,151045,13669,21417,7748,3.7,44,0
12,176253,24113,30547,6434,0.0,45,1
13,149063,-26027,3555,29582,2.0,45,0
14,164612,12925,26234,13309,2.4,44,-1
15,173556,9140,20108,10968,0.0,44,0
16,169469,-4433,15363,19796,0.0,44,0
17,103782,-44221,7268,51489,0.0,44,0
18,103782,-44221,7268,51489,0.0,44,0
19,88477,-18953,1230,20183,0.0,44,0
20,78928,-9801,660,10461,0.0,44,0
21,72442,-6622,592,7214,0.0,43,-1
22,66607,-5976,906,6882,0.0,43,0
23,60524,-5831,857,6688,0.0,42,-1
24,56197,-4659,144,4803,0.0,42,0
0,94805,0,0,0,1.6,65,0
1,66218,-30148,1365,31513,4.6,64,-1
2,46385,-21471,1473,22944,11.5,63,-1
3,82921,24899,35147,10248,11.2,63,0
4,145413,47485,72186,24701,5.2,63,0
5,156321,8386,30586,22200,0.9,63,0
6,157832,-1235,20221,21456,0.5,63,0
7,187806,24882,45826,20944,4.2,63,0
8,167524,-17873,11434,29307,13.0,63,0
9,155632,-12641,7828,20469,10.3,63,0
10,176671,16332,31335,15003,9.3,63,0
11,238925,59145,74811,15666,11.2,63,0
12,401000,158893,172123,13230,2.4,64,1
13,393809,-5116,37823,42939,2.7,64,0
14,413463,15001,57504,42503,1.3,64,0
15,370132,-42981,18306,61287,0.7,64,0
16,309376,-61997,10485,72482,4.4,64,0
17,268223,2196,33048,30852,5.8,63,-1
18,268223,2196,33048,30852,8.1,63,0
19,244764,-21229,12010,33239,5.2,63,0
20,208671,-36002,2254,38256,4.1,62,-1
21,196014,-13238,4279,17517,0.0,62,0
22,177085,-19328,5225,24553,1.0,61,-1
23,156408,-20351,3387,23738,2.4,61,0
24,143681,-13780,893,14673,2.3,60,-1
0,305763,0,0,0,4.4,50,0
1,276330,-42772,6694,49466,6.0,50,0
2,243964,-39678,9182,48860,2.5,49,-1
3,241081,-10423,17200,27623,2.7,49,0
4,220767,-23948,9943,33891,1.7,49,0
5,209736,-14250,6725,20975,2.8,49,0
6,203774,-8550,6168,14718,0.7,49,0
7,197076,-8063,6735,14798,2.4,48,-1
8,193932,-5147,9149,14296,6.8,48,0
9,196257,420,8869,8449,2.4,48,0
10,188882,-7415,5091,12506,5.6,48,0
11,196144,4861,11892,7031,3.5,48,0
12,200117,3411,9853,6442,2.7,48,0
13,198035,-2477,5732,8209,1.2,48,0
14,205904,5888,15242,9354,4.4,48,0
15,203034,-2890,5622,8512,3.7,48,0
16,201922,-1841,8230,10071,2.5,48,0
17,210727,9159,18623,9464,8.4,48,0
18,210727,9159,18623,9464,3.9,48,0
19,202915,-6815,8584,15399,4.4,48,0
20,188775,-14406,2540,16946,2.3,48,0
21,182283,-7110,2089,9199,1.6,48,0
22,175234,-7698,1796,9494,7.5,47,-1
23,170118,-5573,3312,8885,7.0,47,0
24,170163,-1224,3717,4941,2.3,47,0
0,367903,0,0,0,8.0,50,0
1,330238,-44564,14039,58603,2.5,50,0
2,266500,-66564,12006,78570,7.3,50,0
3,266731,-4259,28016,32275,2.8,50,0
4,227185,-39765,20650,60415,5.0,49,-1
5,207643,-21220,10919,32139,2.2,49,0
6,199755,-9033,8533,17566,3.4,49,0
7,195640,-4788,11672,16460,9.4,49,0
8,225536,25889,46506,20617,1.9,49,0
9,259122,31625,44510,12885,2.8,49,0
10,254955,-1294,22234,23528,8.5,49,0
11,345508,84286,94555,10269,8.7,49,0
12,578706,228774,235726,6952,1.8,50,1
13,624219,48395,73984,25589,3.9,50,0
14,703119,73916,104722,30806,14.2,51,1
15,828013,121040,141722,20682,4.8,51,0
16,914010,83735,129759,46024,8.9,52,1
17,1623913,502120,533016,30896,2.8,53,1
18,1623913,502120,533016,30896,3.3,53,0
19,1395869,-137149,76760,213909,16.8,53,0
20,1442893,40096,143511,103415,1.4,53,0
21,1464462,17935,90265,72330,13.4,53,0
22,1706363,230568,257726,27158,4.1,54,1
23,1389480,-304130,70134,374264,3.0,54,0
24,1225256,-184441,35219,219660,1.2,54,0
0,6389,0,0,0,2.5,65,0
1,5983,-1225,244,1469,1.5,65,0
2,5599,-826,345,1171,3.3,64,-1
3,7566,1034,1885,851,13.4,64,0
4,24572,9781,13809,4028,3.2,64,0
5,29880,3085,7542,4457,2.9,64,0
6,31520,481,4948,4467,9.3,64,0
7,144901,98113,105692,7579,1.2,64,0
8,139986,1431,32641,31210,3.8,64,0
9,180724,37465,56580,19115,0.1,65,1
10,146755,-29432,10784,40216,5.1,65,0
11,135092,-15426,9830,25256,2.4,64,-1
12,122735,-12722,6906,19628,1.7,64,0
13,102822,-20354,2048,22402,2.4,63,-1
14,92600,-10595,4099,14694,0.0,62,-1
15,82108,-10819,1511,12330,4.1,62,0
16,73921,-8620,1649,10269,4.4,61,-1
17,67560,1447,6508,5061,4.2,61,0
18,67560,1447,6508,5061,1.5,61,0
19,65777,-1683,4127,5810,8.8,61,0
20,58758,-7042,482,7524,3.1,60,-1
21,56173,-2762,787,3549,0.4,60,0
22,52888,-3418,851,4269,0.0,60,0
23,48485,-4350,450,4800,0.0,59,-1
24,46060,-2720,150,2870,3.8,59,0
0,101787,0,0,0,2.6,45,0
1,94169,-14494,3402,17896,1.7,45,0
2,73311,-22166,2300,24466,0.0,45,0
3,60833,-13422,252,13674,0.0,45,0
4,56691,-5464,1311,6775,0.0,45,0
5,52921,-4179,688,4867,0.0,45,0
6,50004,-3405,439,3844,0.0,45,0
7,47110,-3076,499,3575,0.4,45,0
8,44605,-2656,623,3279,0.0,44,-1
9,43048,-1799,382,2181,0.0,44,0
10,41179,-1929,365,2294,0.0,44,0
11,40036,-1364,400,1764,0.0,44,0
12,39001,-1124,264,1388,2.0,44,0
13,38727,-409,533,942,0.0,43,-1
14,38662,-293,1253,1546,0.0,43,0
15,37939,-762,426,1188,0.0,43,0
16,37233,-785,481,1266,0.0,43,0
17,35207,-844,334,1178,0.0,43,0
18,35207,-844,334,1178,0.0,43,0
19,34763,-650,440,1090,0.0,43,0
20,34237,-567,206,773,0.0,43,0
21,33985,-340,232,572,0.0,43,0
22,33536,-523,288,811,0.0,43,0
23,32711,-864,253,1117,6.2,43,0
24,34681,1691,2362,671,2.3,43,0
0,161367,0,0,0,0.0,40,0
1,163501,-12169,7281,19450,0.0,40,0
2,157717,-12049,8783,20832,0.5,40,0
3,174337,7361,21691,14330,0.0,40,0
4,163418,-10148,7404,17552,0.0,40,0
5,159862,-6573,9017,15590,0.0,40,0
6,156287,-4437,4631,9068,0.0,40,0
7,148557,-7901,1278,9179,0.0,40,0
8,146688,-4587,4115,8702,0.0,39,-1
9,152715,2621,8013,5392,0.0,39,0
10,157560,2662,9294,6632,0.2,39,0
11,167931,9203,15221,6018,0.0,39,0
12,184575,14278,20038,5760,0.0,39,0
13,190906,7876,13935,6059,0.0,39,0
14,206828,11696,21353,9657,5.8,39,0
15,246108,37436,43994,6558,0.0,39,0
16,251253,6148,23043,16895,0.0,39,0
17,254856,-4250,17675,21925,0.0,39,0
18,254856,-4250,17675,21925,0.0,39,0
19,235947,-14333,7819,22152,0.0,39,0
20,223388,-12806,1091,13897,0.0,39,0
21,213759,-10069,1023,11092,0.0,39,0
22,204047,-10096,1721,11817,0.0,39,0
23,194979,-8990,1698,10688,2.2,39,0
24,196991,511,5862,5351,0.3,39,0
0,326,260,275,15,4.4,45,0
1,10400,7226,9701,2475,3.8,45,0
2,12331,2177,3512,1335,5.0,45,0
3,33627,19215,21103,1888,0.9,45,0
4,90739,53371,56794,3423,6.8,45,0
5,157068,61155,71779,10624,8.1,45,0
6,173482,19950,26488,6538,1.0,46,1
7,181184,8200,17200,9000,4.0,46,0
8,185716,2736,11013,8277,4.4,46,0
9,193953,6895,13708,6813,12.1,46,0
10,231140,36100,40616,4516,5.8,46,0
11,361077,124554,131788,7234,5.8,47,1
12,385872,26612,44892,18280,0.0,47,0
13,391682,4888,34598,29710,2.2,47,0
14,598646,161435,183981,22546,2.8,47,0
15,598646,161435,183981,22546,6.8,47,0
16,586286,22372,61953,39581,4.1,47,0
17,549869,-35966,16326,52292,2.4,47,0
18,548103,-3029,16918,19947,6.0,47,0
19,553456,3731,28045,24314,3.2,47,0
20,544074,-9185,29087,38272,3.8,47,0
21,511228,-35601,21526,57127,1.0,47,0
0,412,336,395,59,0.0,45,0
1,689,95,185,90,0.0,45,0
2,851,2,122,120,0.0,45,0
3,1023,17,139,122,0.0,45,0
4,1209,-10,146,156,0.0,45,0
5,1284,-35,83,118,0.0,45,0
6,1390,2,101,99,0.0,45,0
7,1489,-16,101,117,0.0,45,0
8,1529,-25,69,94,0.0,45,0
9,1552,-31,51,82,0.0,45,0
10,1713,-10,125,135,0.0,45,0
11,1768,-5,86,91,1.5,45,0
12,2069,219,379,160,1.2,45,0
13,27713,19502,21494,1992,3.2,45,0
14,27713,19502,21494,1992,1.2,45,0
15,24188,171,3760,3589,7.8,45,0
16,29950,5279,8308,3029,9.5,45,0
17,47276,16091,17680,1589,1.7,45,0
18,59192,11436,14370,2934,3.8,45,0
19,71596,11133,16366,5233,1.1,45,0
20,76263,4391,10739,6348,3.1,45,0
0,8659,7630,8549,919,0.0,60,0
1,11000,2175,3948,1773,0.2,60,0
2,14209,2677,4790,2113,8.1,60,0
3,18461,3491,5789,2298,0.0,60,0
4,15458,-2835,1120,3955,4.9,60,0
5,16296,139,2701,2562,2.7,60,0
6,16996,221,2882,2661,3.7,60,0
7,26825,9164,10743,1579,1.6,60,0
8,25816,-1020,2843,3863,0.9,60,0
9,24763,-1512,2797,4309,0.0,60,0
10,20833,-4097,722,4819,3.8,60,0
11,17267,-3795,665,4460,3.1,60,0
12,16599,1108,2749,1641,2.4,60,0
13,16599,1108,2749,1641,5.2,60,0
14,15406,-1249,1267,2516,8.6,60,0
15,14207,-1353,781,2134,5.1,60,0
16,14442,46,1201,1155,7.8,60,0
17,19342,4353,5358,1005,1.8,60,0
18,17573,-1923,1541,3464,3.3,60,0
19,16319,-1574,756,2330,0.4,60,0
0,0,0,0,0,0.0,40,0
1,0,0,0,0,0.0,40,0
2,568,312,388,76,0.0,40,0
3,796,123,220,97,0.0,40,0
4,1011,98,195,97,0.0,40,0
5,1275,108,250,142,0.0,40,0
6,1685,145,330,185,0.0,40,0
7,1948,105,260,155,0.0,40,0
0,0,0,0,0,0.0,45,0
1,0,0,0,0,0.0,45,0
2,925,651,1011,360,0.0,45,0
3,1597,571,888,317,0.0,45,0
4,2092,365,789,424,0.0,45,0
5,2223,-36,462,498,0.0,45,0
6,2498,41,551,510,0.0,45,0
7,2836,240,630,390,0.0,45,0
0,0,0,0,0,0.0,45,0
1,29,20,28,8,0.0,45,0
0,0,0,0,0,0.0,40,0
1,137,72,82,10,0.0,40,0
0,20303,0,0,0,0.0,45,0
1,22927,-1257,564,1821,0.0,45,0
2,22784,-1475,498,1973,0.0,45,0
3,22361,-1050,293,1343,0.0,45,0
4,21740,-1215,399,1614,0.0,45,0
5,21413,-701,320,1021,0.0,44,-1
6,21151,-476,254,730,0.0,44,0
7,20824,-454,210,664,0.0,44,0
8,20707,-382,291,673,0.0,44,0
9,20519,-302,124,426,0.0,44,0
10,20286,-374,189,563,0.0,44,0
11,20193,-244,237,481,0.0,44,0
12,20080,-216,162,378,0.0,44,0
13,19856,-317,90,407,0.0,44,0
14,19728,-285,152,437,0.0,44,0
15,19586,-210,99,309,0.0,44,0
16,19446,-245,128,373,0.0,44,0
17,19844,-301,333,634,0.0,43,-1
18,19017,-261,126,387,0.0,43,0
19,18913,-265,122,387,0.0,43,0
20,18832,-146,103,249,0.0,43,0
21,18763,-114,72,186,0.0,43,0
22,18658,-158,99,257,0.0,43,0
23,18607,-153,141,294,0.0,43,0
24,18621,-84,140,224,0.0,43,0
25,18464,-222,130,352,0.0,43,0
0,202859,0,0,0,6.7,55,0
1,195761,-19736,8094,27830,2.6,55,0
2,175590,-24959,7497,32456,3.2,55,0
3,170824,-9211,11633,20844,0.5,55,0
4,142220,-28864,2353,31217,2.9,54,-1
5,129700,-14327,1495,15822,0.2,54,0
6,117887,-12702,1046,13748,0.3,53,-1
7,105915,-12206,603,12809,0.0,53,0
8,96535,-9691,929,10620,7.5,52,-1
9,93729,-3486,1025,4511,3.3,52,0
10,89374,-4456,976,5432,2.0,52,0
11,86866,-2950,967,3917,6.2,52,0
12,78211,-8565,82,8647,0.0,52,0
13,76234,-2258,461,2719,3.8,52,0
14,74733,-1712,693,2405,1.5,52,0
15,73877,-997,263,1260,4.2,52,0
16,73196,-813,562,1375,5.0,52,0
17,72855,-999,1156,2155,4.2,52,0
18,71657,-714,540,1254,1.8,52,0
19,70737,-1243,584,1827,0.1,52,0
20,69553,-1254,83,1337,1.6,52,0
21,68836,-794,119,913,8.3,52,0
22,69407,278,985,707,7.8,52,0
23,69301,-343,869,1212,0.9,52,0
24,69152,-398,676,1074,2.9,52,0
25,69264,-84,1036,1120,2.1,52,0
0,375930,0,0,0,1.1,55,0
1,399744,-16218,16639,32857,3.8,55,0
2,483271,48947,95211,46264,3.3,55,0
3,489036,1128,34729,33601,1.8,55,0
4,540479,35780,67249,31469,1.8,55,0
5,562140,14961,35590,20629,0.5,55,0
6,550897,-12752,11124,23876,0.9,55,0
7,551569,-2877,17675,20552,3.4,55,0
8,566846,6454,21069,14615,1.0,55,0
9,553302,-11692,7176,18868,0.9,55,0
10,527305,-24594,5892,30486,2.2,55,0
11,519807,-14379,5569,19948,1.0,55,0
12,495722,-24455,1958,26413,1.1,55,0
13,490704,-8159,7487,15646,1.7,55,0
14,455376,-33638,921,34559,1.8,55,0
15,437345,-19959,588,20547,1.4,55,0
16,432492,-7176,10239,17415,1.0,54,-1
17,421232,-14270,13864,28134,1.0,54,0
18,396886,-18135,6753,24888,1.5,54,0
19,375666,-27491,867,28358,3.8,54,0
20,372868,-4041,3964,8005,0.5,54,0
21,363187,-9840,1239,11079,1.8,54,0
22,355441,-8533,1564,10097,1.4,53,-1
23,348339,-7211,2655,9866,1.4,53,0
24,345901,-4132,3616,7748,5.5,53,0
25,353383,4412,12182,7770,3.8,53,0
0,138741,0,0,0,2.2,55,0
1,153262,-6419,8762,15181,2.3,55,0
2,171768,5356,24615,19259,1.6,55,0
3,163545,-10619,7838,18457,3.2,55,0
4,170819,626,14430,13804,1.8,55,0
5,180790,7034,16225,9191,1.6,55,0
6,191602,8602,17362,8760,1.7,55,0
7,203765,10280,18706,8426,3.7,55,0
8,210804,3542,13918,10376,2.0,55,0
9,206225,-4080,5497,9577,1.3,55,0
10,197429,-8747,4389,13136,2.1,55,0
11,190455,-9031,3727,12758,0.0,55,0
12,175409,-15297,1054,16351,2.4,55,0
13,157264,-18492,599,19091,0.0,55,0
14,143024,-14371,715,15086,0.0,54,-1
15,135555,-8035,503,8538,0.0,54,0
16,124884,-10874,71,10945,0.0,54,0
17,109437,-12682,113,12795,0.0,54,0
18,107161,-5356,86,5442,15.4,54,0
19,110286,1758,3987,2229,1.7,54,0
20,115294,4412,6176,1764,2.4,54,0
21,115879,259,3537,3278,3.4,54,0
22,116176,-335,3160,3495,0.0,54,0
23,105851,-10010,605,10615,0.0,54,0
24,99686,-6535,65,6600,0.0,54,0
25,95161,-4544,58,4602,0.0,54,0
0,556410,0,0,0,2.2,50,0
1,599340,-8498,41971,50469,2.1,50,0
2,661881,35736,102525,66789,1.2,50,0
3,628713,-33772,27906,61678,1.3,50,0
4,624749,-12133,35943,48076,1.4,50,0
5,643960,12300,38460,26160,2.3,50,0
6,647688,1170,22649,21479,2.1,50,0
7,651128,2423,23678,21255,1.7,50,0
8,590477,-51984,11157,63141,0.0,50,0
9,547740,-50716,2579,53295,2.4,50,0
10,531894,-17401,8855,26256,1.5,50,0
11,516899,-20155,5702,25857,3.4,50,0
12,496455,-20669,3143,23812,2.7,49,-1
13,499272,-266,13189,13455,2.0,49,0
14,470332,-27820,5533,33353,2.4,49,0
15,458251,-13765,4482,18247,1.4,49,0
16,459177,-1201,15785,16986,3.5,49,0
17,460049,-11034,19330,30364,1.8,49,0
18,418134,-24958,4242,29200,0.1,49,0
19,395236,-31142,1938,33080,2.0,48,-1
20,389404,-6964,4143,11107,1.5,48,0
21,380790,-8994,2189,11183,1.7,48,0
22,371424,-10057,2249,12306,1.4,48,0
23,364642,-6761,3892,10653,2.0,48,0
24,364403,-2070,5527,7597,2.0,48,0
25,368149,2751,10564,7813,1.2,48,0
0,1082647,0,0,0,9.8,85,0
1,1282778,29769,155911,126142,6.9,85,0
2,1561217,198215,349218,151003,5.4,85,0
3,1732369,141241,329362,188121,4.0,86,1
4,1536040,-195675,106656,302331,6.7,86,0
5,1439521,-115095,64980,180075,9.3,85,-1
6,1414577,-38064,48565,86629,3.7,85,0
7,1275832,-135077,50066,185143,1.4,85,0
8,1158637,-126674,39528,166202,7.8,84,-1
9,1037257,-125606,10666,136272,0.0,84,0
10,591490,-439424,1879,441303,0.0,83,-1
11,495067,-117585,220,117805,0.0,82,-1
12,464893,-31842,106,31948,0.0,82,0
13,445255,-20070,88,20158,0.0,82,0
14,423272,-21929,118,22047,0.0,82,0
15,416928,-6970,65,7035,0.0,82,0
16,409353,-7676,104,7780,0.0,82,0
17,397826,-10999,220,11219,0.0,82,0
18,395327,-3402,119,3521,0.0,82,0
19,389062,-6302,144,6446,0.0,82,0
20,386474,-2806,130,2936,0.0,82,0
21,383801,-2692,105,2797,0.0,82,0
22,380201,-3589,82,3671,0.0,82,0
23,376609,-3666,119,3785,0.0,82,0
24,374176,-2550,154,2704,0.0,81,-1
25,371741,-2492,182,2674,0.0,81,0
0,177607,0,0,0,10.2,50,0
1,385987,117769,163098,45329,1.4,50,0
2,816549,347814,439854,92040,1.4,51,1
3,840002,29271,106684,77413,3.9,51,0
4,1087824,199732,275090,75358,2.7,51,0
5,1342548,237092,270891,33799,1.4,52,1
6,1661633,302811,326735,23924,0.0,53,1
7,1494986,-152088,80653,232741,0.0,53,0
8,1241579,-252007,31746,283753,0.0,52,-1
9,881204,-366551,3564,370115,0.0,51,-1
10,662150,-222215,1622,223837,0.0,51,0
11,607219,-72819,3933,76752,4.1,51,0
12,577790,-31262,3792,35054,2.5,51,0
13,578637,-2565,20226,22791,2.1,51,0
14,531685,-44836,4706,49542,11.5,51,0
15,542456,7547,20889,13342,4.4,50,-1
16,692815,142758,161057,18299,7.6,50,0
17,1154483,164137,214633,50496,2.4,51,1
18,762844,-61511,27298,88809,2.8,51,0
19,703662,-88019,8570,96589,0.0,51,0
20,651891,-53264,6704,59968,0.0,50,-1
21,545703,-105874,532,106406,0.0,50,0
22,442693,-103773,100,103873,0.0,49,-1
23,416223,-26535,3042,29577,1.9,49,0
24,414211,-4538,5817,10355,1.7,49,0
25,420093,4835,15396,10561,2.2,49,0
0,2930,0,0,0,0.0,55,0
1,2558,-620,84,704,0.0,55,0
2,2194,-481,115,596,0.0,55,0
3,1991,-253,66,319,0.0,54,-1
4,1843,-182,62,244,0.0,54,0
5,1734,-120,38,158,0.0,54,0
6,1674,-71,40,111,0.0,54,0
7,1628,-60,32,92,0.0,54,0
8,1583,-57,42,99,0.0,54,0
9,1587,-5,36,41,0.0,54,0
10,1595,-6,35,41,0.0,54,0
11,1588,-17,39,56,0.0,54,0
12,1579,-12,23,35,0.0,54,0
13,1562,-18,14,32,0.0,54,0
14,1561,-14,18,32,0.0,54,0
15,1570,1,18,17,0.0,54,0
16,1580,7,34,27,0.0,54,0
17,1579,-13,49,62,0.0,54,0
18,1586,8,28,20,0.0,54,0
19,1602,7,46,39,0.0,54,0
20,1636,24,45,21,0.0,54,0
21,1633,-1,37,38,0.0,54,0
22,1631,-9,24,33,1.5,54,0
23,2174,408,514,106,2.4,54,0
24,2889,575,786,211,0.7,54,0
25,3316,281,626,345,2.4,54,0
0,145802,0,0,0,3.6,50,0
1,140174,-11171,10750,21921,0.0,50,0
2,119282,-22046,6918,28964,0.0,50,0
3,103006,-17627,3777,21404,9.0,49,-1
4,91288,-12900,4596,17496,4.2,49,0
5,86131,-6103,4097,10200,1.8,49,0
6,83166,-3642,3442,7084,3.6,49,0
7,80419,-3005,4462,7467,2.3,49,0
8,74371,-5879,3505,9384,5.2,48,-1
9,72597,-2572,2195,4767,3.9,48,0
10,71963,-987,4237,5224,6.0,48,0
11,71847,-362,3606,3968,5.1,48,0
12,71396,-541,3220,3761,1.7,48,0
13,63583,-7788,696,8484,0.0,48,0
14,56109,-7346,497,7843,0.0,47,-1
15,52425,-3953,276,4229,0.0,47,0
16,48250,-4282,262,4544,0.0,47,0
17,48159,-2356,2058,4414,3.8,47,0
18,44980,-918,1890,2808,7.9,47,0
19,43463,-2012,970,2982,2.1,47,0
20,41504,-2007,620,2627,5.6,47,0
21,40370,-1203,403,1606,0.9,47,0
22,39146,-1271,378,1649,1.0,46,-1
23,38603,-631,1110,1741,1.7,46,0
24,38320,-461,835,1296,4.8,46,0
25,40134,1489,2905,1416,2.1,46,0
0,1189095,0,0,0,3.2,65,0
1,1192596,-102740,59207,161947,6.7,65,0
2,1079344,-150445,66003,216448,1.6,65,0
3,1025920,-79097,66904,146001,0.4,65,0
4,842684,-190973,22727,213700,1.4,64,-1
5,749359,-105668,14567,120235,1.9,64,0
6,665159,-91919,8945,100864,2.4,63,-1
7,578447,-88734,3901,92635,0.7,63,0
8,524031,-57397,4662,62059,3.7,62,-1
9,503060,-24615,4133,28748,5.1,62,0
10,480840,-23593,5119,28712,6.9,62,0
11,470497,-12913,6630,19543,5.5,62,0
12,462552,-8830,5628,14458,2.1,61,-1
13,452687,-10732,4815,15547,6.0,61,0
14,438679,-14938,3811,18749,3.8,61,0
15,433719,-6085,1948,8033,5.4,61,0
16,429615,-5092,4446,9538,5.8,61,0
17,442590,-69,12698,12767,0.0,61,0
18,420042,-10745,1379,12124,9.0,61,0
19,414136,-8086,2186,10272,1.7,61,0
20,409954,-4866,1135,6001,1.0,60,-1
21,405731,-4747,943,5690,2.9,60,0
22,401517,-4870,1006,5876,8.2,60,0
23,396927,-5207,1077,6284,3.9,60,0
24,394719,-3082,1852,4934,3.6,60,0
25,396505,626,4820,4194,13.6,60,0
0,158296,0,0,0,1.6,55,0
1,156296,-19607,6268,25875,5.1,55,0
2,147330,-15438,7587,23025,4.4,55,0
3,146123,-5498,9875,15373,2.0,54,-1
4,131894,-15641,3537,19178,3.1,54,0
5,122290,-10961,1811,12772,4.0,54,0
6,117251,-6456,2163,8619,8.3,53,-1
7,112339,-5451,2166,7617,4.9,53,0
8,107256,-5731,2272,8003,2.3,53,0
9,103930,-3873,1298,5171,1.2,53,0
10,98823,-5271,1465,6736,0.6,52,-1
11,96902,-2543,1773,4316,0.1,52,0
12,94857,-2260,1321,3581,4.3,52,0
13,93940,-1242,1900,3142,8.1,52,0
14,92621,-1663,2318,3981,6.8,52,0
15,91623,-1266,949,2215,6.1,52,0
16,91261,-721,1863,2584,8.8,52,0
17,122973,10968,17166,6198,9.4,52,0
18,115926,12024,18462,6438,1.2,52,0
19,103500,-12142,2521,14663,1.5,52,0
20,100228,-3900,2279,6179,0.0,52,0
21,96630,-3840,1330,5170,6.7,51,-1
22,97896,601,3190,2589,5.4,51,0
23,96899,-1189,3058,4247,9.6,51,0
24,109486,10960,14430,3470,1.5,51,0
25,120705,9693,17700,8007,10.7,51,0
0,17314,0,0,0,4.4,55,0
1,47771,22114,35402,13288,6.1,55,0
2,424856,351024,411832,60808,0.0,56,1
3,379939,-31844,61888,93732,0.6,56,0
4,317946,-66440,24266,90706,3.5,56,0
5,288945,-32379,15334,47713,7.1,55,-1
6,264381,-26857,14464,41321,9.8,55,0
7,292674,24547,51668,27121,2.7,55,0
8,255450,-35506,21145,56651,7.8,55,0
9,230738,-27114,11825,38939,8.3,54,-1
10,244733,10591,34861,24270,2.3,54,0
11,270441,22590,40868,18278,9.9,54,0
12,263036,-6497,20472,26969,6.4,54,0
13,398272,127759,136307,8548,7.3,55,1
14,419081,20321,59795,39474,5.6,55,0
15,408438,-12091,25148,37239,0.5,55,0
16,398628,-12475,38497,50972,0.0,55,0
17,186561,-137581,9477,147058,0.0,55,0
18,164086,-106313,152,106465,0.0,54,-1
19,123971,-46992,116,47108,0.6,53,-1
20,114939,-9763,2833,12596,2.6,53,0
21,110328,-4920,2010,6930,2.7,53,0
22,104588,-6000,1033,7033,0.0,53,0
23,92039,-12261,560,12821,0.0,53,0
24,85346,-7106,47,7153,0.0,53,0
25,80328,-5015,53,5068,0.0,53,0
0,108444,0,0,0,0.0,40,0
1,122040,-4861,8312,13173,0.0,40,0
2,127608,-2907,11450,14357,0.0,40,0
3,130061,-2181,7902,10083,3.7,40,0
4,259179,104204,137494,33290,4.7,40,0
5,605593,322498,338967,16469,2.7,41,1
6,822723,215730,233706,17976,1.5,42,1
7,1021320,189467,211488,22021,0.9,43,1
8,1135884,107065,145739,38674,4.9,43,0
9,1164747,31619,63382,31763,0.2,43,0
10,1114697,-38602,31579,70181,0.0,43,0
11,1060083,-68777,19765,88542,0.0,43,0
12,950874,-109501,8832,118333,0.0,43,0
13,852633,-103512,16608,120120,0.6,42,-1
14,817629,-37816,40037,77853,0.0,42,0
15,777985,-40680,17704,58384,1.3,42,0
16,778004,-3362,48250,51612,0.5,41,-1
17,800127,-12354,66037,78391,0.0,41,0
18,674231,-75165,24675,99840,0.0,41,0
19,627664,-68896,15754,84650,1.8,40,-1
20,620494,-9267,23796,33063,3.7,40,0
21,611353,-9677,16680,26357,4.1,40,0
22,597433,-14852,17908,32760,3.4,40,0
23,618121,19444,46424,26980,0.0,40,0
24,624036,4003,30735,26732,0.0,40,0
25,601307,-22976,32740,55716,0.0,40,0
0,522,0,0,0,0.0,50,0
1,477,-94,45,139,0.0,50,0
2,471,-40,46,86,0.0,50,0
3,451,-31,36,67,0.0,50,0
4,439,-26,37,63,0.0,50,0
5,432,-11,20,31,0.0,50,0
6,428,-11,15,26,0.0,50,0
7,438,5,33,28,0.0,49,-1
8,423,-20,7,27,0.0,49,0
9,419,-7,5,12,0.0,49,0
10,443,20,38,18,0.0,49,0
11,444,-5,24,29,0.0,49,0
12,440,-7,15,22,0.0,49,0
13,426,-15,6,21,0.0,49,0
14,430,1,10,9,0.0,49,0
15,430,0,5,5,0.0,49,0
16,426,-6,6,12,0.0,49,0
17,593,37,84,47,0.8,49,0
18,570,62,112,50,4.2,49,0
19,585,-10,50,60,0.0,49,0
20,584,-17,22,39,0.0,49,0
21,587,-13,16,29,0.0,49,0
22,582,-20,12,32,0.1,49,0
23,615,0,33,33,0.0,49,0
24,622,-12,16,28,0.0,49,0
25,637,2,31,29,0.0,49,0
0,13748,0,0,0,4.0,55,0
1,32122,9371,15911,6540,5.0,55,0
2,44254,8598,19559,10961,6.0,55,0
3,78653,29540,40987,11447,11.2,55,0
4,95820,14275,31935,17660,4.6,55,0
5,105534,7834,19247,11413,7.4,55,0
6,114385,6747,19036,12289,11.1,55,0
7,135506,19074,31888,12814,6.5,55,0
8,138388,1568,19697,18129,9.4,55,0
9,161734,20035,32663,12628,11.4,55,0
10,306608,130071,144362,14291,5.1,56,1
11,457928,147719,170292,22573,6.4,57,1
12,480124,26481,71070,44589,10.4,57,0
13,911750,414077,426333,12256,4.7,58,1
14,958980,47502,138997,91495,10.1,59,1
15,1033047,65920,112830,46910,6.7,59,0
16,1204316,161641,227847,66206,3.9,60,1
17,1454295,91910,218244,126334,11.2,60,0
18,935298,-305153,36345,341498,11.8,60,0
19,853595,-150491,43677,194168,2.4,59,-1
20,696345,-158922,12110,171032,8.5,58,-1
21,603593,-95392,8895,104287,10.0,58,0
22,581031,-26095,17002,43097,8.8,57,-1
23,524006,-54921,21083,76004,11.3,57,0
24,546159,13079,49532,36453,5.0,57,0
25,573088,22019,70033,48014,12.6,57,0
0,17621,0,0,0,0.0,50,0
1,23573,-447,3813,4260,0.0,50,0
2,24856,-1786,3589,5375,0.0,50,0
3,24636,-2083,2286,4369,0.0,50,0
4,23921,-2331,1569,3900,0.0,49,-1
5,24594,-431,1831,2262,0.0,49,0
6,23848,-1200,895,2095,0.0,49,0
7,22959,-1195,520,1715,0.0,49,0
8,22406,-1012,548,1560,0.0,48,-1
9,22389,-343,483,826,0.0,48,0
10,22625,-173,839,1012,0.0,48,0
11,22915,15,1019,1004,0.0,48,0
12,23005,-147,627,774,0.0,48,0
13,22757,-427,424,851,0.0,48,0
14,22982,-223,777,1000,0.0,48,0
15,23093,-86,459,545,0.0,48,0
16,23135,-162,531,693,0.0,48,0
17,25280,239,1481,1242,0.0,48,0
18,24149,75,838,763,0.0,48,0
19,23932,-297,803,1100,0.0,48,0
20,24044,-27,566,593,0.0,48,0
21,23973,-180,447,627,0.0,48,0
22,23831,-334,349,683,0.0,48,0
23,23899,-159,588,747,0.0,48,0
24,24171,58,713,655,0.0,48,0
25,24266,-90,672,762,0.0,48,0
0,75604,0,0,0,0.0,55,0
1,81758,-8462,10433,18895,0.0,55,0
2,69314,-16157,6195,22352,5.6,55,0
3,60035,-11647,3227,14874,0.0,54,-1
4,50687,-10723,2051,12774,0.0,53,-1
5,47292,-4447,1840,6287,0.0,53,0
6,43143,-4674,839,5513,0.2,53,0
7,41126,-2357,1007,3364,0.3,52,-1
8,39593,-1949,1289,3238,0.0,52,0
9,38669,-1170,575,1745,7.4,52,0
10,45036,5342,7483,2141,0.2,52,0
11,45387,418,3782,3364,5.6,52,0
12,48560,2583,5297,2714,1.6,52,0
13,52273,3318,6352,3034,5.6,52,0
14,58411,4958,9471,4513,3.7,52,0
15,63122,4358,8088,3730,0.3,52,0
16,72231,8267,15536,7269,3.3,52,0
17,155441,32047,49712,17665,2.5,52,0
18,113342,8763,27672,18909,12.6,52,0
19,128942,12551,35366,22815,0.0,52,0
20,120766,-8118,9595,17713,0.2,52,0
21,109194,-12007,4901,16908,0.0,52,0
22,96394,-13216,2809,16025,2.3,52,0
23,87785,-8862,4717,13579,0.0,52,0
24,84797,-3952,4432,8384,2.1,52,0
25,80258,-4752,4889,9641,4.3,52,0
0,15739,0,0,0,1.7,50,0
1,23118,3066,8299,5233,0.4,50,0
2,20169,-3629,9868,13497,0.0,50,0
3,14847,-5488,397,5885,0.0,49,-1
4,13471,-1646,2066,3712,0.0,49,0
5,13505,-277,1271,1548,2.3,49,0
6,12813,-937,520,1457,0.0,49,0
7,10048,-2709,43,2752,0.9,48,-1
8,9695,-615,269,884,0.0,48,0
9,9223,-582,139,721,2.5,48,0
10,9308,-80,394,474,1.3,48,0
11,9544,84,517,433,1.1,48,0
12,9637,6,386,380,3.2,48,0
13,11733,1856,2289,433,0.0,48,0
14,10526,-1258,327,1585,1.3,48,0
15,10334,-288,256,544,0.0,48,0
16,9950,-476,419,895,0.0,48,0
17,8317,-1239,32,1271,0.0,48,0
18,8079,-646,12,658,0.0,48,0
19,7685,-469,12,481,0.0,47,-1
20,7474,-216,17,233,0.0,47,0
21,7312,-162,9,171,0.0,47,0
22,7167,-149,11,160,0.0,47,0
23,7012,-154,18,172,0.0,47,0
24,7103,6,82,76,1.4,47,0
25,6977,-130,20,150,0.0,47,0
0,2432,0,0,0,0.2,50,0
1,2901,-276,288,564,0.0,50,0
2,2711,-475,190,665,2.0,50,0
3,2665,-257,180,437,0.0,50,0
4,2510,-314,106,420,0.0,49,-1
5,2440,-164,55,219,0.0,49,0
6,2350,-147,56,203,0.0,49,0
7,2250,-144,48,192,0.0,48,-1
8,2217,-109,45,154,0.1,48,0
9,2213,-31,36,67,0.0,48,0
10,2199,-54,27,81,0.3,48,0
11,2194,-33,37,70,0.0,48,0
12,2182,-28,32,60,3.0,48,0
13,2316,99,154,55,0.1,48,0
14,2348,-10,79,89,0.0,48,0
15,2348,-19,34,53,1.3,48,0
16,2416,42,152,110,3.3,48,0
17,3533,248,560,312,0.3,48,0
18,2681,-66,84,150,0.0,48,0
19,2551,-171,39,210,0.0,48,0
20,2463,-100,16,116,0.1,48,0
21,2432,-48,24,72,3.7,48,0
22,2415,-39,33,72,0.0,47,-1
23,2408,-41,27,68,0.0,47,0
24,2376,-42,22,64,0.0,47,0
25,2371,-24,30,54,0.0,47,0
0,911,463,699,236,2.2,45,0
1,1862,411,689,278,0.9,45,0
2,2443,171,510,339,0.0,45,0
3,2664,23,300,277,0.0,45,0
4,2811,-52,226,278,0.0,45,0
5,2799,-137,161,298,0.0,45,0
6,2882,-114,129,243,0.0,45,0
7,2879,-102,81,183,0.0,45,0
8,2875,-91,72,163,0.0,45,0
9,2893,-67,101,168,0.0,44,-1
10,2885,-53,78,131,0.0,44,0
11,2868,-63,76,139,0.0,44,0
12,2955,-12,149,161,0.0,44,0
13,2976,-23,65,88,4.2,44,0
14,3444,362,509,147,0.0,44,0
15,4289,165,510,345,0.3,44,0
16,3645,-64,137,201,0.0,44,0
17,3561,-148,125,273,0.6,44,0
18,3582,-19,103,122,0.6,44,0
19,3634,23,118,95,0.0,44,0
20,3593,-93,68,161,1.0,44,0
21,3638,-9,132,141,0.0,44,0
22,3657,-44,86,130,0.0,44,0
23,3653,-50,78,128,0.1,44,0
0,36150,29089,36050,6961,2.1,55,0
1,75787,29218,41228,12010,4.2,55,0
2,125665,36935,55747,18812,1.4,55,0
3,159417,29411,39596,10185,4.7,55,0
4,178782,16239,28955,12716,6.0,55,0
5,242112,55631,68582,12951,4.3,55,0
6,280280,28603,47425,18822,4.7,56,1
7,268386,-8464,15220,23684,3.7,56,0
8,254186,-15346,12016,27362,1.3,56,0
9,234781,-23499,7664,31163,4.9,55,-1
10,215055,-20870,3117,23987,4.1,55,0
11,214240,-3508,10907,14415,2.4,55,0
12,189288,-24764,3817,28581,4.1,54,-1
13,181864,-9025,2751,11776,0.0,54,0
14,176367,-6983,7543,14526,4.5,54,0
15,178811,-4333,11464,15797,4.2,54,0
16,163543,-8979,3672,12651,4.6,53,-1
17,151819,-14427,1580,16007,1.1,53,0
18,151752,-975,3950,4925,4.2,53,0
19,148988,-3259,2420,5679,3.0,53,0
20,146498,-3279,2913,6192,2.5,53,0
21,148976,1351,6687,5336,4.1,52,-1
22,157046,6543,11043,4500,8.8,52,0
23,175336,15777,22766,6989,1.6,52,0
0,1033,714,1266,552,0.0,50,0
1,1175,-8,304,312,0.0,50,0
2,1190,-133,162,295,7.5,50,0
3,22022,18649,20584,1935,1.3,50,0
4,19754,-1181,4440,5621,6.9,50,0
5,28017,5756,8819,3063,0.0,50,0
6,24454,-3388,2769,6157,2.4,50,0
7,21314,-3595,659,4254,0.0,50,0
8,17659,-3820,191,4011,0.0,50,0
9,15139,-2717,362,3079,4.5,50,0
10,12918,-2339,317,2656,0.4,50,0
11,12306,-758,203,961,4.1,50,0
12,12881,357,1541,1184,0.9,50,0
13,16499,541,2518,1977,5.3,50,0
14,15968,2169,3883,1714,0.2,50,0
15,13713,-2397,555,2952,0.3,50,0
16,11751,-2011,160,2171,0.0,50,0
17,10047,-1725,32,1757,0.0,50,0
18,8877,-1189,22,1211,0.0,50,0
19,8361,-550,168,718,0.0,50,0
20,8550,50,337,287,0.0,50,0
21,8524,-113,292,405,0.0,50,0
0,0,0,0,0,0.0,45,0
1,316,171,221,50,0.0,45,0
2,509,101,194,93,0.0,45,0
3,666,55,139,84,0.0,45,0
4,947,92,194,102,0.0,45,0
5,1102,74,180,106,0.0,45,0
6,1262,51,177,126,0.0,45,0
7,1406,63,208,145,0.0,45,0
8,1550,90,214,124,5.9,45,0
9,1824,238,381,143,0.4,45,0
10,2214,304,533,229,0.6,45,0
11,2188,-30,149,179,0.0,45,0
12,2075,-130,131,261,0.4,45,0
13,3170,70,513,443,0.0,45,0
14,2072,-139,100,239,0.0,45,0
15,1941,-183,62,245,0.0,45,0
16,1805,-147,18,165,0.0,45,0
17,1738,-90,22,112,0.0,45,0
18,1660,-96,14,110,0.0,45,0
19,1621,-58,34,92,0.0,45,0
20,1587,-52,28,80,0.0,45,0
21,1573,-34,47,81,0.0,45,0
0,0,0,0,0,0.0,45,0
1,85,43,50,7,0.0,45,0
2,133,15,40,25,0.0,45,0
3,152,-5,20,25,0.0,45,0
4,300,21,64,43,0.0,45,0
5,244,-2,16,18,0.0,45,0
6,254,-8,31,39,0.0,45,0
7,274,4,23,19,0.0,45,0
8,287,-6,15,21,0.0,45,0
9,295,-11,18,29,0.0,45,0
10,313,-3,22,25,0.0,45,0
11,341,6,30,24,0.0,45,0
12,400,18,48,30,0.0,45,0
0,0,0,0,0,0.0,45,0
1,243,130,166,36,0.0,45,0
2,333,48,90,42,0.0,45,0
3,367,-6,43,49,0.0,45,0
4,616,25,129,104,0.0,45,0
5,518,2,47,45,0.0,45,0
6,547,-14,63,77,0.0,45,0
7,551,-21,33,54,0.0,45,0
8,574,2,47,45,0.0,45,0
9,599,-26,25,51,0.0,45,0
10,648,-5,51,56,0.0,45,0
11,709,22,77,55,0.0,45,0
12,741,-14,78,92,0.0,45,0
0,0,0,0,0,0.0,45,0
1,71,45,56,11,0.0,45,0
2,221,94,142,48,0.0,45,0
3,1096,168,279,111,0.0,45,0
4,653,13,101,88,0.0,45,0
5,689,24,121,97,0.0,45,0
6,708,-22,67,89,0.0,45,0
7,761,15,94,79,0.0,45,0
8,773,-21,58,79,0.0,45,0
9,850,8,111,103,0.0,45,0
10,879,-10,86,96,0.0,45,0
11,1001,43,151,108,0.0,45,0
0,0,0,0,0,0.0,40,0
1,351,203,248,45,0.0,40,0
2,3276,604,834,230,0.0,40,0
3,1643,72,243,171,0.0,40,0
4,1797,-6,204,210,0.0,40,0
5,1896,-11,137,148,0.0,40,0
6,1994,-18,116,134,0.0,40,0
7,2140,-19,141,160,0.0,40,0
8,2379,20,187,167,0.0,40,0
9,2538,10,144,134,0.0,40,0
10,2715,-14,170,184,0.0,40,0
0,0,0,0,0,0.0,40,0
1,419,224,258,34,0.0,40,0
2,4262,634,941,307,0.0,40,0
3,1756,18,174,156,0.0,40,0
4,1774,-62,144,206,0.0,40,0
5,1840,-34,101,135,0.0,40,0
6,1926,-30,69,99,0.0,40,0
7,2022,-52,78,130,0.0,40,0
8,4201,1387,1790,403,0.0,39,-1
9,5381,1061,1615,554,0.0,39,0
10,7570,1281,2268,987,0.0,39,0
0,0,0,0,0,0.0,40,0
1,65400,7700,9144,1444,0.0,40,0
2,20399,4960,6620,1660,0.0,40,0
3,17793,2745,4588,1843,0.0,40,0
4,20173,1898,2912,1014,0.0,40,0
5,22129,1474,2555,1081,0.0,40,0
6,22057,-296,1347,1643,0.0,40,0
7,21997,-584,1070,1654,0.0,40,0
8,21939,-173,829,1002,0.0,40,0
9,22155,-412,1297,1709,0.0,40,0
0,0,0,0,0,0.0,40,0
1,681,247,304,57,0.0,40,0
2,730,140,237,97,0.0,40,0
3,927,100,180,80,0.0,40,0
4,980,-29,76,105,0.0,40,0
5,1061,-38,63,101,0.0,40,0
6,1192,-18,89,107,0.0,40,0
7,1312,-15,70,85,0.0,40,0
8,1437,-6,88,94,0.0,40,0
0,1743,1647,2105,458,0.6,70,0
1,8808,6752,7597,845,6.9,70,0
2,13493,4408,6439,2031,4.5,70,0
3,19092,4993,7239,2246,0.4,70,0
4,19023,-303,5344,5647,4.8,70,0
5,22081,2319,7349,5030,5.5,70,0
6,20524,-1925,4746,6671,1.7,70,0
0,0,0,0,0,0.0,40,0
1,207,125,147,22,0.0,40,0
2,506,138,210,72,0.0,40,0
3,892,137,246,109,0.0,40,0
4,1106,116,220,104,0.0,40,0
5,1377,63,248,185,0.0,40,0
